a relaxed posture	('PEACEFULNESS', 'PHYSICAL SIGNALS'),('NOSTALGIA', 'PHYSICAL SIGNALS')
screaming	('RAGE', 'PHYSICAL SIGNALS'),('DESPERATION', 'CUES OF ACUTE OR LONG-TERM')
a corded neck	('RAGE', 'PHYSICAL SIGNALS'),('HATRED', 'PHYSICAL SIGNALS'),('ANTICIPATION', 'CUES OF SUPPRESSED'),('ANGUISH', 'PHYSICAL SIGNALS')
tightness in the chest	('IRRITATION', 'INTERNAL SENSATIONS'),('CONFLICTED', 'INTERNAL SENSATIONS'),('FRUSTRATION', 'INTERNAL SENSATIONS'),('SKEPTICISM', 'INTERNAL SENSATIONS')
anxiety attacks	('WORRY', 'CUES OF ACUTE OR LONG-TERM'),('TERROR', 'CUES OF ACUTE OR LONG-TERM')
shrugging	('DOUBT', 'PHYSICAL SIGNALS'),('DENIAL', 'PHYSICAL SIGNALS'),('SKEPTICISM', 'PHYSICAL SIGNALS'),('DETERMINATION', 'CUES OF SUPPRESSED')
interrupting	('IRRITATION', 'PHYSICAL SIGNALS'),('DEFENSIVENESS', 'PHYSICAL SIGNALS')
clasping one’s hands together	('WORRY', 'PHYSICAL SIGNALS'),('NERVOUSNESS', 'CUES OF SUPPRESSED')
swearing	('IRRITATION', 'CUES OF ACUTE OR LONG-TERM'),('FRUSTRATION', 'PHYSICAL SIGNALS'),('FRUSTRATION', 'PHYSICAL SIGNALS'),('JEALOUSY', 'PHYSICAL SIGNALS')
a shake of the head	('DISBELIEF', 'PHYSICAL SIGNALS'),('RESIGNATION', 'PHYSICAL SIGNALS')
fanning oneself	('EXCITEMENT', 'PHYSICAL SIGNALS'),('AMAZEMENT', 'PHYSICAL SIGNALS')
swallowing hard	('HURT', 'PHYSICAL SIGNALS'),('DISGUST', 'PHYSICAL SIGNALS'),('DISAPPOINTMENT', 'PHYSICAL SIGNALS')
wetting the lips	('RELUCTANCE', 'PHYSICAL SIGNALS'),('ANTICIPATION', 'PHYSICAL SIGNALS')
collapsing	('RELIEF', 'CUES OF ACUTE OR LONG-TERM'),('AMAZEMENT', 'CUES OF ACUTE OR LONG-TERM')
feigning interest in something else	('DESIRE', 'CUES OF ACUTE OR LONG-TERM'),('CONTEMPT', 'CUES OF SUPPRESSED')
complaining	('ANNOYANCE', 'PHYSICAL SIGNALS'),('RESENTMENT', 'PHYSICAL SIGNALS')
breathlessness	('ELATION', 'CUES OF ACUTE OR LONG-TERM'),('SURPRISE/SHOCK', 'INTERNAL SENSATIONS'),('SURPRISE/SHOCK', 'MENTAL RESPONSES'),('ADORATION', 'INTERNAL SENSATIONS'),('ANTICIPATION', 'INTERNAL SENSATIONS'),('EAGERNESS', 'INTERNAL SENSATIONS'),('EXCITEMENT', 'INTERNAL SENSATIONS'),('AMUSEMENT', 'CUES OF ACUTE OR LONG-TERM')
increasing one’s personal space	('WARINESS', 'CUES OF ACUTE OR LONG-TERM'),('DEFENSIVENESS', 'CUES OF ACUTE OR LONG-TERM')
rushed speech	('FRUSTRATION', 'PHYSICAL SIGNALS'),('INSECURITY', 'PHYSICAL SIGNALS')
rocking in place	('ANXIETY', 'PHYSICAL SIGNALS'),('DESPERATION', 'PHYSICAL SIGNALS')
widening eyes	('SURPRISE/SHOCK', 'CUES OF SUPPRESSED'),('DENIAL', 'PHYSICAL SIGNALS')
drooping shoulders	('HURT', 'PHYSICAL SIGNALS'),('SADNESS', 'PHYSICAL SIGNALS')
throat clearing	('DISBELIEF', 'CUES OF SUPPRESSED'),('DOUBT', 'PHYSICAL SIGNALS'),('WORRY', 'PHYSICAL SIGNALS'),('GUILT', 'CUES OF SUPPRESSED'),('UNEASE', 'PHYSICAL SIGNALS'),('AGITATION', 'PHYSICAL SIGNALS'),('INSECURITY', 'PHYSICAL SIGNALS')
an inability to concentrate on anything else	('GUILT', 'MENTAL RESPONSES'),('EAGERNESS', 'MENTAL RESPONSES')
retreating inward	('RESIGNATION', 'CUES OF ACUTE OR LONG-TERM'),('OVERWHELMED', 'MENTAL RESPONSES')
flushed skin	('CONTEMPT', 'CUES OF SUPPRESSED'),('LOVE', 'CUES OF SUPPRESSED'),('SUSPICION', 'PHYSICAL SIGNALS')
sarcasm	('IRRITATION', 'CUES OF ACUTE OR LONG-TERM'),('SCORN', 'PHYSICAL SIGNALS')
a heaviness in the body	('CONFLICTED', 'INTERNAL SENSATIONS'),('DISAPPOINTMENT', 'INTERNAL SENSATIONS')
stuttering stammering	('RELUCTANCE', 'PHYSICAL SIGNALS'),('SURPRISE/SHOCK', 'PHYSICAL SIGNALS'),('EMBARRASSMENT', 'PHYSICAL SIGNALS'),('AMAZEMENT', 'CUES OF SUPPRESSED')
a set jaw	('DETERMINATION', 'PHYSICAL SIGNALS'),('SUSPICION', 'PHYSICAL SIGNALS')
a stony expression	('DISAPPOINTMENT', 'PHYSICAL SIGNALS'),('AMAZEMENT', 'CUES OF SUPPRESSED')
making excuses	('DISBELIEF', 'CUES OF SUPPRESSED'),('RELUCTANCE', 'PHYSICAL SIGNALS'),('DEPRESSION', 'PHYSICAL SIGNALS'),('AGITATION', 'CUES OF SUPPRESSED')
negative thought patterns	('PARANOIA', 'MENTAL RESPONSES'),('NERVOUSNESS', 'CUES OF ACUTE OR LONG-TERM')
walking away	('DISBELIEF', 'CUES OF ACUTE OR LONG-TERM'),('CONTEMPT', 'PHYSICAL SIGNALS'),('RESENTMENT', 'CUES OF SUPPRESSED'),('SKEPTICISM', 'PHYSICAL SIGNALS')
asking pointed questions	('IRRITATION', 'PHYSICAL SIGNALS'),('DETERMINATION', 'PHYSICAL SIGNALS')
a downturned mouth	('REGRET', 'PHYSICAL SIGNALS'),('DEPRESSION', 'PHYSICAL SIGNALS'),('CONTEMPT', 'PHYSICAL SIGNALS')
closing the eyes	('GRATITUDE', 'CUES OF SUPPRESSED'),('OVERWHELMED', 'PHYSICAL SIGNALS')
blinking	('SADNESS', 'CUES OF SUPPRESSED'),('CURIOSITY', 'PHYSICAL SIGNALS')
frowning	('UNCERTAINTY', 'PHYSICAL SIGNALS'),('IRRITATION', 'PHYSICAL SIGNALS'),('UNEASE', 'PHYSICAL SIGNALS'),('IMPATIENCE', 'PHYSICAL SIGNALS'),('CONFUSION', 'PHYSICAL SIGNALS'),('DISAPPOINTMENT', 'PHYSICAL SIGNALS')
high blood pressure	('WORRY', 'CUES OF ACUTE OR LONG-TERM'),('CONTEMPT', 'CUES OF ACUTE OR LONG-TERM'),('FRUSTRATION', 'INTERNAL SENSATIONS'),('RESENTMENT', 'INTERNAL SENSATIONS'),('RESENTMENT', 'CUES OF ACUTE OR LONG-TERM'),('LONELINESS', 'CUES OF ACUTE OR LONG-TERM')
indecision	('RELUCTANCE', 'MENTAL RESPONSES'),('UNCERTAINTY', 'MENTAL RESPONSES')
crying sobbing	('REGRET', 'CUES OF ACUTE OR LONG-TERM'),('FRUSTRATION', 'CUES OF ACUTE OR LONG-TERM')
biting one’s lip	('WORRY', 'PHYSICAL SIGNALS'),('ANTICIPATION', 'PHYSICAL SIGNALS'),('CONFUSION', 'PHYSICAL SIGNALS')
smoothing down clothing	('EXCITEMENT', 'CUES OF SUPPRESSED'),('INSECURITY', 'PHYSICAL SIGNALS')
an inability to move on	('NOSTALGIA', 'CUES OF ACUTE OR LONG-TERM'),('DISAPPOINTMENT', 'CUES OF ACUTE OR LONG-TERM')
raised eyebrows	('DENIAL', 'PHYSICAL SIGNALS'),('CURIOSITY', 'PHYSICAL SIGNALS')
a loss of appetite	('WORRY', 'INTERNAL SENSATIONS'),('RESIGNATION', 'PHYSICAL SIGNALS')
a negative outlook	('SOMBERNESS', 'MENTAL RESPONSES'),('DEPRESSION', 'MENTAL RESPONSES')
heightened senses	('PARANOIA', 'INTERNAL SENSATIONS'),('WARINESS', 'MENTAL RESPONSES'),('EXCITEMENT', 'INTERNAL SENSATIONS')
warmth radiating throughout the body	('ELATION', 'INTERNAL SENSATIONS'),('SMUGNESS', 'INTERNAL SENSATIONS')
leaning forward	('ADORATION', 'PHYSICAL SIGNALS'),('EAGERNESS', 'PHYSICAL SIGNALS')
panic attacks	('ANXIETY', 'CUES OF ACUTE OR LONG-TERM'),('SHAME', 'CUES OF ACUTE OR LONG-TERM'),('NERVOUSNESS', 'CUES OF ACUTE OR LONG-TERM')
a frozen smile	('DISGUST', 'CUES OF SUPPRESSED'),('IMPATIENCE', 'CUES OF SUPPRESSED')
toes curling up	('DISGUST', 'PHYSICAL SIGNALS'),('EMBARRASSMENT', 'PHYSICAL SIGNALS')
stooped posture	('SADNESS', 'PHYSICAL SIGNALS'),('WORRY', 'PHYSICAL SIGNALS'),('RESIGNATION', 'PHYSICAL SIGNALS')
making promises	('CONFUSION', 'CUES OF SUPPRESSED'),('DISAPPOINTMENT', 'CUES OF SUPPRESSED')
arms hanging at the sides	('REMORSE', 'PHYSICAL SIGNALS'),('SHAME', 'PHYSICAL SIGNALS')
a fake smile	('EMBARRASSMENT', 'CUES OF SUPPRESSED'),('SUSPICION', 'PHYSICAL SIGNALS')
false bravado	('FEAR', 'CUES OF SUPPRESSED'),('DEFEAT', 'CUES OF SUPPRESSED'),('LONELINESS', 'PHYSICAL SIGNALS')
a lack of eye contact	('DEFEAT', 'PHYSICAL SIGNALS'),('NERVOUSNESS', 'PHYSICAL SIGNALS'),('LONELINESS', 'PHYSICAL SIGNALS'),('DETERMINATION', 'CUES OF SUPPRESSED')
grinding one’s teeth	('ANNOYANCE', 'CUES OF ACUTE OR LONG-TERM'),('ANGER', 'INTERNAL SENSATIONS'),('ANGUISH', 'PHYSICAL SIGNALS')
gasping for air	('TERROR', 'PHYSICAL SIGNALS'),('AMUSEMENT', 'PHYSICAL SIGNALS')
running hands through the hair	('DOUBT', 'PHYSICAL SIGNALS'),('FRUSTRATION', 'PHYSICAL SIGNALS'),('CONFUSION', 'PHYSICAL SIGNALS')
blushing	('ADORATION', 'CUES OF SUPPRESSED'),('GUILT', 'PHYSICAL SIGNALS')
a darting gaze	('ANXIETY', 'PHYSICAL SIGNALS'),('DESPERATION', 'PHYSICAL SIGNALS'),('DEFENSIVENESS', 'PHYSICAL SIGNALS')
scowling	('RESENTMENT', 'PHYSICAL SIGNALS'),('IMPATIENCE', 'PHYSICAL SIGNALS')
runny nose	('REMORSE', 'INTERNAL SENSATIONS'),('HUMILIATION', 'PHYSICAL SIGNALS')
looking down or away	('DISBELIEF', 'PHYSICAL SIGNALS'),('DOUBT', 'PHYSICAL SIGNALS'),('HOPEFULNESS', 'CUES OF SUPPRESSED')
a tightening chest	('ANXIETY', 'INTERNAL SENSATIONS'),('RELUCTANCE', 'INTERNAL SENSATIONS'),('EMBARRASSMENT', 'INTERNAL SENSATIONS'),('CONFUSION', 'INTERNAL SENSATIONS'),('DISAPPOINTMENT', 'INTERNAL SENSATIONS')
a trembling chin	('HURT', 'PHYSICAL SIGNALS'),('SADNESS', 'PHYSICAL SIGNALS'),('SHAME', 'PHYSICAL SIGNALS'),('EMBARRASSMENT', 'PHYSICAL SIGNALS')
changing the topic	('DISBELIEF', 'CUES OF SUPPRESSED'),('NERVOUSNESS', 'CUES OF SUPPRESSED'),('ANTICIPATION', 'CUES OF SUPPRESSED')
rising blood pressure	('IRRITATION', 'CUES OF ACUTE OR LONG-TERM'),('CONTEMPT', 'INTERNAL SENSATIONS')
falling to one’s knees	('GRATITUDE', 'CUES OF ACUTE OR LONG-TERM'),('ELATION', 'PHYSICAL SIGNALS')
picking fights	('SCORN', 'CUES OF ACUTE OR LONG-TERM'),('JEALOUSY', 'CUES OF ACUTE OR LONG-TERM')
sweating	('ELATION', 'PHYSICAL SIGNALS'),('DENIAL', 'PHYSICAL SIGNALS'),('PARANOIA', 'PHYSICAL SIGNALS'),('ANGER', 'PHYSICAL SIGNALS'),('ANGER', 'INTERNAL SENSATIONS'),('HATRED', 'PHYSICAL SIGNALS'),('GUILT', 'PHYSICAL SIGNALS'),('DREAD', 'PHYSICAL SIGNALS'),('AGITATION', 'INTERNAL SENSATIONS'),('CONFUSION', 'INTERNAL SENSATIONS'),('EXCITEMENT', 'CUES OF ACUTE OR LONG-TERM')
an inability to focus	('WORRY', 'MENTAL RESPONSES'),('OVERWHELMED', 'MENTAL RESPONSES')
avoiding conversation	('ANXIETY', 'CUES OF SUPPRESSED'),('NERVOUSNESS', 'CUES OF SUPPRESSED'),('ANTICIPATION', 'CUES OF SUPPRESSED')
restlessness	('FRUSTRATION', 'PHYSICAL SIGNALS'),('HOPEFULNESS', 'PHYSICAL SIGNALS')
shakiness in the limbs	('FEAR', 'INTERNAL SENSATIONS'),('DREAD', 'INTERNAL SENSATIONS')
passive-aggressive comments	('RELUCTANCE', 'CUES OF SUPPRESSED'),('IRRITATION', 'CUES OF SUPPRESSED'),('ANGER', 'CUES OF SUPPRESSED')
baring one’s teeth	('ANGER', 'PHYSICAL SIGNALS'),('FRUSTRATION', 'PHYSICAL SIGNALS')
clenching the jaw	('ANNOYANCE', 'PHYSICAL SIGNALS'),('PARANOIA', 'PHYSICAL SIGNALS'),('FRUSTRATION', 'PHYSICAL SIGNALS'),('ANGUISH', 'PHYSICAL SIGNALS')
name-calling	('IRRITATION', 'CUES OF ACUTE OR LONG-TERM'),('RESENTMENT', 'PHYSICAL SIGNALS')
reacting with anger or jealousy if one’s reputation is impugned	('PRIDE', 'CUES OF ACUTE OR LONG-TERM'),('CONFIDENCE', 'CUES OF ACUTE OR LONG-TERM')
adrenaline rush	('EXCITEMENT', 'INTERNAL SENSATIONS'),('SUSPICION', 'INTERNAL SENSATIONS')
yawning	('INDIFFERENCE', 'PHYSICAL SIGNALS'),('DETERMINATION', 'CUES OF SUPPRESSED')
lightheadedness	('DISBELIEF', 'INTERNAL SENSATIONS'),('EMBARRASSMENT', 'INTERNAL SENSATIONS')
insomnia	('REGRET', 'INTERNAL SENSATIONS'),('FEAR', 'CUES OF ACUTE OR LONG-TERM'),('RAGE', 'CUES OF ACUTE OR LONG-TERM'),('PARANOIA', 'PHYSICAL SIGNALS'),('TERROR', 'CUES OF ACUTE OR LONG-TERM'),('GUILT', 'CUES OF ACUTE OR LONG-TERM'),('RESENTMENT', 'CUES OF ACUTE OR LONG-TERM'),('LONELINESS', 'INTERNAL SENSATIONS')
a quivering chin	('REMORSE', 'PHYSICAL SIGNALS'),('GUILT', 'PHYSICAL SIGNALS')
a puffed-up feeling	('SCORN', 'INTERNAL SENSATIONS'),('SMUGNESS', 'INTERNAL SENSATIONS')
grimacing	('GUILT', 'PHYSICAL SIGNALS'),('CONFUSION', 'PHYSICAL SIGNALS')
feeling overheated	('AGITATION', 'INTERNAL SENSATIONS'),('CONFUSION', 'INTERNAL SENSATIONS')
hiding behind one’s hair	('REGRET', 'PHYSICAL SIGNALS'),('INSECURITY', 'PHYSICAL SIGNALS')
a jutting chin	('SKEPTICISM', 'PHYSICAL SIGNALS'),('SMUGNESS', 'PHYSICAL SIGNALS')
difficulty breathing	('DREAD', 'INTERNAL SENSATIONS'),('OVERWHELMED', 'INTERNAL SENSATIONS')
illness	('DEPRESSION', 'PHYSICAL SIGNALS'),('RESENTMENT', 'CUES OF ACUTE OR LONG-TERM')
arguing	('DISBELIEF', 'CUES OF ACUTE OR LONG-TERM'),('RESENTMENT', 'PHYSICAL SIGNALS')
excessive swallowing	('ANXIETY', 'PHYSICAL SIGNALS'),('EMBARRASSMENT', 'INTERNAL SENSATIONS'),('DEFENSIVENESS', 'PHYSICAL SIGNALS'),('UNEASE', 'PHYSICAL SIGNALS'),('CONFUSION', 'PHYSICAL SIGNALS')
an unfocused gaze	('DISBELIEF', 'PHYSICAL SIGNALS'),('NOSTALGIA', 'PHYSICAL SIGNALS')
tears	('SHAME', 'PHYSICAL SIGNALS'),('HOPEFULNESS', 'CUES OF ACUTE OR LONG-TERM'),('RESIGNATION', 'PHYSICAL SIGNALS')
wanting to hide	('SURPRISE/SHOCK', 'MENTAL RESPONSES'),('DREAD', 'MENTAL RESPONSES')
narrowed eyes	('SCORN', 'PHYSICAL SIGNALS'),('SKEPTICISM', 'PHYSICAL SIGNALS'),('CONFUSION', 'PHYSICAL SIGNALS')
joyful tears	('GRATITUDE', 'CUES OF ACUTE OR LONG-TERM'),('HAPPINESS', 'CUES OF ACUTE OR LONG-TERM')
jumping at sounds	('DREAD', 'CUES OF ACUTE OR LONG-TERM'),('ANGUISH', 'PHYSICAL SIGNALS')
a thrust-out chest	('SCORN', 'PHYSICAL SIGNALS'),('SMUGNESS', 'PHYSICAL SIGNALS')
dry washing one’s hands	('CONTEMPT', 'CUES OF SUPPRESSED'),('CONFUSION', 'PHYSICAL SIGNALS')
rising body temperature	('HATRED', 'INTERNAL SENSATIONS'),('ADORATION', 'INTERNAL SENSATIONS'),('ENVY', 'INTERNAL SENSATIONS'),('IMPATIENCE', 'INTERNAL SENSATIONS'),('AMAZEMENT', 'INTERNAL SENSATIONS')
forcing oneself to maintain eye contact	('HURT', 'CUES OF SUPPRESSED'),('INSECURITY', 'CUES OF SUPPRESSED')
weakness in the knees	('GRATITUDE', 'INTERNAL SENSATIONS'),('HURT', 'PHYSICAL SIGNALS')
trembling hands	('RELIEF', 'PHYSICAL SIGNALS'),('ANTICIPATION', 'PHYSICAL SIGNALS')
exhaustion	('FEAR', 'CUES OF ACUTE OR LONG-TERM'),('GUILT', 'CUES OF ACUTE OR LONG-TERM')
an unnatural stillness	('SOMBERNESS', 'PHYSICAL SIGNALS'),('NERVOUSNESS', 'CUES OF SUPPRESSED')
whimpering	('HOPEFULNESS', 'CUES OF ACUTE OR LONG-TERM'),('HUMILIATION', 'PHYSICAL SIGNALS')
a sharp tone	('ANNOYANCE', 'PHYSICAL SIGNALS'),('IMPATIENCE', 'PHYSICAL SIGNALS')
pacing	('ANNOYANCE', 'PHYSICAL SIGNALS'),('WORRY', 'PHYSICAL SIGNALS'),('DESPERATION', 'PHYSICAL SIGNALS'),('NERVOUSNESS', 'PHYSICAL SIGNALS'),('UNEASE', 'CUES OF ACUTE OR LONG-TERM'),('ANTICIPATION', 'PHYSICAL SIGNALS'),('IMPATIENCE', 'PHYSICAL SIGNALS'),('AGITATION', 'PHYSICAL SIGNALS'),('SUSPICION', 'PHYSICAL SIGNALS')
using sarcasm	('CONTEMPT', 'PHYSICAL SIGNALS'),('DEFENSIVENESS', 'PHYSICAL SIGNALS')
laughing	('ELATION', 'PHYSICAL SIGNALS'),('EXCITEMENT', 'PHYSICAL SIGNALS')
a pinched expression	('ANNOYANCE', 'PHYSICAL SIGNALS'),('JEALOUSY', 'PHYSICAL SIGNALS')
a cracking voice	('DEFEAT', 'PHYSICAL SIGNALS'),('GUILT', 'PHYSICAL SIGNALS')
sneering	('CONTEMPT', 'PHYSICAL SIGNALS'),('JEALOUSY', 'PHYSICAL SIGNALS')
a reddening of the face	('ANGER', 'PHYSICAL SIGNALS'),('ENVY', 'PHYSICAL SIGNALS'),('AGITATION', 'PHYSICAL SIGNALS'),('AMUSEMENT', 'CUES OF SUPPRESSED')
abusive relationships	('REGRET', 'CUES OF ACUTE OR LONG-TERM'),('SHAME', 'CUES OF ACUTE OR LONG-TERM')
hypertension	('ANGER', 'CUES OF ACUTE OR LONG-TERM'),('OVERWHELMED', 'MENTAL RESPONSES')
raising one’s voice	('DENIAL', 'PHYSICAL SIGNALS'),('DEFENSIVENESS', 'PHYSICAL SIGNALS')
crossed arms	('ANNOYANCE', 'PHYSICAL SIGNALS'),('SMUGNESS', 'PHYSICAL SIGNALS')
a lack of energy	('DEFEAT', 'INTERNAL SENSATIONS'),('INDIFFERENCE', 'INTERNAL SENSATIONS')
weight loss	('REGRET', 'CUES OF ACUTE OR LONG-TERM'),('REMORSE', 'CUES OF ACUTE OR LONG-TERM'),('WORRY', 'CUES OF ACUTE OR LONG-TERM'),('PARANOIA', 'PHYSICAL SIGNALS'),('EMBARRASSMENT', 'CUES OF ACUTE OR LONG-TERM'),('ADORATION', 'CUES OF ACUTE OR LONG-TERM'),('TERROR', 'CUES OF ACUTE OR LONG-TERM')
hesitation	('WARINESS', 'PHYSICAL SIGNALS'),('WARINESS', 'CUES OF SUPPRESSED')
obsessive thoughts	('DEPRESSION', 'MENTAL RESPONSES'),('DESIRE', 'CUES OF ACUTE OR LONG-TERM'),('CURIOSITY', 'CUES OF ACUTE OR LONG-TERM')
suicide	('SHAME', 'CUES OF ACUTE OR LONG-TERM'),('ANGUISH', 'CUES OF ACUTE OR LONG-TERM')
deep breaths	('SADNESS', 'CUES OF SUPPRESSED'),('HOPEFULNESS', 'PHYSICAL SIGNALS')
sensitive skin	('IRRITATION', 'INTERNAL SENSATIONS'),('NERVOUSNESS', 'INTERNAL SENSATIONS')
staring down at one’s hands	('SADNESS', 'PHYSICAL SIGNALS'),('DEPRESSION', 'PHYSICAL SIGNALS'),('DENIAL', 'PHYSICAL SIGNALS')
anger	('SCORN', 'MENTAL RESPONSES'),('SKEPTICISM', 'CUES OF ACUTE OR LONG-TERM')
loss of appetite	('REGRET', 'INTERNAL SENSATIONS'),('SADNESS', 'CUES OF ACUTE OR LONG-TERM'),('EMBARRASSMENT', 'CUES OF ACUTE OR LONG-TERM'),('CONFLICTED', 'INTERNAL SENSATIONS'),('GUILT', 'INTERNAL SENSATIONS'),('NERVOUSNESS', 'INTERNAL SENSATIONS')
a shaking voice	('HATRED', 'PHYSICAL SIGNALS'),('DESPERATION', 'PHYSICAL SIGNALS')
turning away from others	('AGITATION', 'PHYSICAL SIGNALS'),('ANGUISH', 'PHYSICAL SIGNALS')
light-headedness	('DESIRE', 'INTERNAL SENSATIONS'),('RELIEF', 'CUES OF ACUTE OR LONG-TERM'),('AGITATION', 'INTERNAL SENSATIONS'),('OVERWHELMED', 'INTERNAL SENSATIONS')
wringing one’s hands	('ANXIETY', 'PHYSICAL SIGNALS'),('DESPERATION', 'PHYSICAL SIGNALS')
smiling	('HAPPINESS', 'PHYSICAL SIGNALS'),('ADORATION', 'PHYSICAL SIGNALS'),('HOPEFULNESS', 'PHYSICAL SIGNALS')
a heavy sigh	('REGRET', 'PHYSICAL SIGNALS'),('FRUSTRATION', 'PHYSICAL SIGNALS'),('SKEPTICISM', 'PHYSICAL SIGNALS'),('LONELINESS', 'PHYSICAL SIGNALS'),('DISAPPOINTMENT', 'PHYSICAL SIGNALS')
a pinched mouth	('CONTEMPT', 'PHYSICAL SIGNALS'),('RESENTMENT', 'PHYSICAL SIGNALS')
holding the head in the hands	('ANNOYANCE', 'PHYSICAL SIGNALS'),('RESIGNATION', 'PHYSICAL SIGNALS')
wanting to be alone	('RESENTMENT', 'MENTAL RESPONSES'),('DISAPPOINTMENT', 'MENTAL RESPONSES')
rocking back and forth	('RELIEF', 'PHYSICAL SIGNALS'),('ANGUISH', 'PHYSICAL SIGNALS'),('OVERWHELMED', 'PHYSICAL SIGNALS')
lips parting	('DESIRE', 'PHYSICAL SIGNALS'),('RELIEF', 'PHYSICAL SIGNALS'),('ADORATION', 'PHYSICAL SIGNALS'),('AMAZEMENT', 'PHYSICAL SIGNALS')
hyperventilating	('ANXIETY', 'CUES OF ACUTE OR LONG-TERM'),('DREAD', 'CUES OF ACUTE OR LONG-TERM'),('OVERWHELMED', 'PHYSICAL SIGNALS')
headache	('ANGER', 'CUES OF SUPPRESSED'),('HATRED', 'INTERNAL SENSATIONS'),('NERVOUSNESS', 'INTERNAL SENSATIONS')
racing heartbeat	('SURPRISE/SHOCK', 'INTERNAL SENSATIONS'),('DESPERATION', 'INTERNAL SENSATIONS'),('EXCITEMENT', 'CUES OF ACUTE OR LONG-TERM')
eating disorders	('DEPRESSION', 'CUES OF ACUTE OR LONG-TERM'),('SHAME', 'CUES OF ACUTE OR LONG-TERM')
a monotone voice	('RESIGNATION', 'PHYSICAL SIGNALS'),('LONELINESS', 'PHYSICAL SIGNALS')
leaning in	('HOPEFULNESS', 'PHYSICAL SIGNALS'),('ANTICIPATION', 'PHYSICAL SIGNALS'),('AMAZEMENT', 'PHYSICAL SIGNALS')
turning away	('SADNESS', 'CUES OF SUPPRESSED'),('INDIFFERENCE', 'PHYSICAL SIGNALS'),('GUILT', 'PHYSICAL SIGNALS'),('SCORN', 'CUES OF SUPPRESSED')
ugly laughter	('CONTEMPT', 'PHYSICAL SIGNALS'),('JEALOUSY', 'PHYSICAL SIGNALS')
avoiding eye contact	('DISBELIEF', 'CUES OF SUPPRESSED'),('DOUBT', 'PHYSICAL SIGNALS'),('ANGER', 'CUES OF SUPPRESSED'),('DREAD', 'PHYSICAL SIGNALS'),('RESIGNATION', 'PHYSICAL SIGNALS'),('AGITATION', 'PHYSICAL SIGNALS')
pressing the lips together	('DOUBT', 'PHYSICAL SIGNALS'),('DETERMINATION', 'PHYSICAL SIGNALS')
uncontrollable whimpering	('FEAR', 'PHYSICAL SIGNALS'),('DREAD', 'PHYSICAL SIGNALS')
lying	('RELUCTANCE', 'PHYSICAL SIGNALS'),('DEPRESSION', 'CUES OF SUPPRESSED'),('EMBARRASSMENT', 'CUES OF SUPPRESSED'),('GUILT', 'PHYSICAL SIGNALS'),('INSECURITY', 'CUES OF SUPPRESSED')
feigning boredom	('CURIOSITY', 'CUES OF SUPPRESSED'),('ANTICIPATION', 'CUES OF SUPPRESSED')
tense muscles	('IRRITATION', 'INTERNAL SENSATIONS'),('WARINESS', 'INTERNAL SENSATIONS'),('SKEPTICISM', 'INTERNAL SENSATIONS')
dizziness	('ANXIETY', 'INTERNAL SENSATIONS'),('HURT', 'INTERNAL SENSATIONS'),('DREAD', 'INTERNAL SENSATIONS')
tight muscles	('EAGERNESS', 'CUES OF SUPPRESSED'),('JEALOUSY', 'PHYSICAL SIGNALS'),('DETERMINATION', 'PHYSICAL SIGNALS')
self-loathing	('REGRET', 'MENTAL RESPONSES'),('DEFEAT', 'CUES OF ACUTE OR LONG-TERM'),('ENVY', 'MENTAL RESPONSES'),('GUILT', 'CUES OF ACUTE OR LONG-TERM'),('HUMILIATION', 'MENTAL RESPONSES')
backing away	('DENIAL', 'PHYSICAL SIGNALS'),('WARINESS', 'PHYSICAL SIGNALS'),('DEFEAT', 'PHYSICAL SIGNALS')
bouncing on one’s toes	('ANTICIPATION', 'PHYSICAL SIGNALS'),('EAGERNESS', 'PHYSICAL SIGNALS')
giddiness	('SURPRISE/SHOCK', 'PHYSICAL SIGNALS'),('AMAZEMENT', 'MENTAL RESPONSES')
jumpiness	('RELUCTANCE', 'PHYSICAL SIGNALS'),('WORRY', 'CUES OF SUPPRESSED'),('NERVOUSNESS', 'PHYSICAL SIGNALS')
flaring nostrils	('ANGER', 'PHYSICAL SIGNALS'),('HATRED', 'PHYSICAL SIGNALS'),('ENVY', 'PHYSICAL SIGNALS'),('TERROR', 'PHYSICAL SIGNALS')
headaches	('REMORSE', 'CUES OF ACUTE OR LONG-TERM'),('CONFLICTED', 'INTERNAL SENSATIONS'),('IMPATIENCE', 'INTERNAL SENSATIONS'),('DETERMINATION', 'CUES OF ACUTE OR LONG-TERM'),('OVERWHELMED', 'MENTAL RESPONSES')
the mouth falling open	('SURPRISE/SHOCK', 'PHYSICAL SIGNALS'),('DISAPPOINTMENT', 'PHYSICAL SIGNALS')
keeping at a distance	('GUILT', 'PHYSICAL SIGNALS'),('UNEASE', 'CUES OF SUPPRESSED')
a booming laugh	('PRIDE', 'PHYSICAL SIGNALS'),('CONFIDENCE', 'PHYSICAL SIGNALS')
hyperventilation	('TERROR', 'INTERNAL SENSATIONS'),('ANGUISH', 'CUES OF ACUTE OR LONG-TERM')
neck bending forward	('DISBELIEF', 'PHYSICAL SIGNALS'),('HUMILIATION', 'PHYSICAL SIGNALS')
crying	('SADNESS', 'PHYSICAL SIGNALS'),('DEPRESSION', 'PHYSICAL SIGNALS'),('EMBARRASSMENT', 'CUES OF ACUTE OR LONG-TERM')
a loss of inhibitions	('DESIRE', 'MENTAL RESPONSES'),('EXCITEMENT', 'CUES OF ACUTE OR LONG-TERM')
wishing time would speed up	('DREAD', 'MENTAL RESPONSES'),('NERVOUSNESS', 'MENTAL RESPONSES'),('IMPATIENCE', 'MENTAL RESPONSES')
a bowed head	('RELIEF', 'PHYSICAL SIGNALS'),('HUMILIATION', 'PHYSICAL SIGNALS')
shoving hands in pockets	('DOUBT', 'PHYSICAL SIGNALS'),('EMBARRASSMENT', 'PHYSICAL SIGNALS')
pain in the back of the throat	('GUILT', 'INTERNAL SENSATIONS'),('ANGUISH', 'INTERNAL SENSATIONS')
ulcers	('REGRET', 'CUES OF ACUTE OR LONG-TERM'),('WORRY', 'CUES OF ACUTE OR LONG-TERM'),('RAGE', 'CUES OF ACUTE OR LONG-TERM'),('ANGER', 'CUES OF ACUTE OR LONG-TERM')
an inability to eat	('ANXIETY', 'PHYSICAL SIGNALS'),('OVERWHELMED', 'INTERNAL SENSATIONS')
dry mouth	('WORRY', 'INTERNAL SENSATIONS'),('RELIEF', 'INTERNAL SENSATIONS'),('DEFENSIVENESS', 'INTERNAL SENSATIONS'),('NERVOUSNESS', 'INTERNAL SENSATIONS'),('EXCITEMENT', 'INTERNAL SENSATIONS')
making an excuse to leave	('REMORSE', 'CUES OF SUPPRESSED'),('INDIFFERENCE', 'CUES OF SUPPRESSED'),('SCORN', 'CUES OF SUPPRESSED')
difficulty swallowing	('DREAD', 'INTERNAL SENSATIONS'),('ANGUISH', 'INTERNAL SENSATIONS')
rigid body posture	('DEFENSIVENESS', 'PHYSICAL SIGNALS'),('SKEPTICISM', 'PHYSICAL SIGNALS')
stalking	('ADORATION', 'CUES OF ACUTE OR LONG-TERM'),('SUSPICION', 'CUES OF ACUTE OR LONG-TERM')
nightmares	('TERROR', 'CUES OF ACUTE OR LONG-TERM'),('GUILT', 'CUES OF ACUTE OR LONG-TERM')
steady eye contact	('GRATITUDE', 'PHYSICAL SIGNALS'),('DENIAL', 'CUES OF SUPPRESSED')
head shaking	('ANXIETY', 'PHYSICAL SIGNALS'),('CONTEMPT', 'PHYSICAL SIGNALS')
staring down at one’s feet	('REGRET', 'PHYSICAL SIGNALS'),('GUILT', 'PHYSICAL SIGNALS')
eavesdropping	('CURIOSITY', 'PHYSICAL SIGNALS'),('SUSPICION', 'PHYSICAL SIGNALS')
risk taking	('TERROR', 'MENTAL RESPONSES'),('INSECURITY', 'CUES OF SUPPRESSED')
facial tics	('IRRITATION', 'CUES OF ACUTE OR LONG-TERM'),('NERVOUSNESS', 'PHYSICAL SIGNALS')
nausea	('REMORSE', 'INTERNAL SENSATIONS'),('NERVOUSNESS', 'INTERNAL SENSATIONS'),('HUMILIATION', 'INTERNAL SENSATIONS'),('ANGUISH', 'INTERNAL SENSATIONS')
changing the subject	('SADNESS', 'CUES OF SUPPRESSED'),('IRRITATION', 'PHYSICAL SIGNALS'),('DEFENSIVENESS', 'CUES OF SUPPRESSED'),('GUILT', 'CUES OF SUPPRESSED'),('AGITATION', 'CUES OF SUPPRESSED')
stumbling back a step	('HURT', 'PHYSICAL SIGNALS'),('RELIEF', 'PHYSICAL SIGNALS')
depression	('FEAR', 'CUES OF ACUTE OR LONG-TERM'),('SHAME', 'CUES OF ACUTE OR LONG-TERM'),('RAGE', 'CUES OF ACUTE OR LONG-TERM'),('NOSTALGIA', 'CUES OF ACUTE OR LONG-TERM'),('TERROR', 'CUES OF ACUTE OR LONG-TERM'),('GUILT', 'CUES OF ACUTE OR LONG-TERM'),('RESIGNATION', 'CUES OF ACUTE OR LONG-TERM'),('ANGUISH', 'CUES OF ACUTE OR LONG-TERM')
rapid blinking	('DISBELIEF', 'PHYSICAL SIGNALS'),('SURPRISE/SHOCK', 'CUES OF SUPPRESSED'),('FEAR', 'PHYSICAL SIGNALS'),('NERVOUSNESS', 'PHYSICAL SIGNALS'),('CONFUSION', 'PHYSICAL SIGNALS')
rolling the eyes	('CONTEMPT', 'PHYSICAL SIGNALS'),('SMUGNESS', 'PHYSICAL SIGNALS')
licking one’s lips	('LOVE', 'PHYSICAL SIGNALS'),('DEFENSIVENESS', 'PHYSICAL SIGNALS'),('SKEPTICISM', 'PHYSICAL SIGNALS')
wishing to be somewhere else	('ANNOYANCE', 'MENTAL RESPONSES'),('DISGUST', 'MENTAL RESPONSES')
tingling skin	('SURPRISE/SHOCK', 'INTERNAL SENSATIONS'),('AMAZEMENT', 'INTERNAL SENSATIONS')
weeping	('DREAD', 'CUES OF ACUTE OR LONG-TERM'),('OVERWHELMED', 'MENTAL RESPONSES')
substance abuse	('FEAR', 'CUES OF ACUTE OR LONG-TERM'),('SHAME', 'CUES OF ACUTE OR LONG-TERM'),('TERROR', 'CUES OF ACUTE OR LONG-TERM')
fidgeting	('CONTEMPT', 'CUES OF SUPPRESSED'),('DESPERATION', 'CUES OF SUPPRESSED'),('GUILT', 'CUES OF SUPPRESSED'),('CONFUSION', 'CUES OF SUPPRESSED'),('INSECURITY', 'PHYSICAL SIGNALS')
trembling	('DESIRE', 'PHYSICAL SIGNALS'),('EXCITEMENT', 'PHYSICAL SIGNALS')
tunnel vision	('RAGE', 'INTERNAL SENSATIONS'),('OVERWHELMED', 'INTERNAL SENSATIONS')
scrubbing a hand over the face	('REGRET', 'PHYSICAL SIGNALS'),('FRUSTRATION', 'PHYSICAL SIGNALS')
crossing the arms	('IMPATIENCE', 'PHYSICAL SIGNALS'),('SUSPICION', 'PHYSICAL SIGNALS')
lightness in the chest	('CONFIDENCE', 'INTERNAL SENSATIONS'),('EXCITEMENT', 'INTERNAL SENSATIONS')
irritability	('WORRY', 'MENTAL RESPONSES'),('ANGER', 'MENTAL RESPONSES'),('NERVOUSNESS', 'CUES OF ACUTE OR LONG-TERM')
a pensive expression	('SOMBERNESS', 'PHYSICAL SIGNALS'),('CONFLICTED', 'PHYSICAL SIGNALS')
wincing	('SADNESS', 'PHYSICAL SIGNALS'),('EMBARRASSMENT', 'PHYSICAL SIGNALS'),('ANGUISH', 'CUES OF SUPPRESSED')
strong eye contact	('HOPEFULNESS', 'PHYSICAL SIGNALS'),('EAGERNESS', 'PHYSICAL SIGNALS'),('DETERMINATION', 'PHYSICAL SIGNALS')
biting the lip	('SADNESS', 'CUES OF SUPPRESSED'),('DISGUST', 'CUES OF SUPPRESSED')
telling oneself that it doesn’t matter	('ANTICIPATION', 'CUES OF SUPPRESSED'),('JEALOUSY', 'CUES OF SUPPRESSED')
fatigue	('DEPRESSION', 'INTERNAL SENSATIONS'),('RAGE', 'CUES OF ACUTE OR LONG-TERM'),('PARANOIA', 'INTERNAL SENSATIONS'),('LONELINESS', 'INTERNAL SENSATIONS')
adrenaline spikes	('FEAR', 'INTERNAL SENSATIONS'),('AMAZEMENT', 'INTERNAL SENSATIONS')
being at a loss for words	('DISBELIEF', 'PHYSICAL SIGNALS'),('RESIGNATION', 'PHYSICAL SIGNALS')
pursing the lips	('DOUBT', 'PHYSICAL SIGNALS'),('WARINESS', 'PHYSICAL SIGNALS')
isolation	('PARANOIA', 'CUES OF ACUTE OR LONG-TERM'),('HATRED', 'CUES OF ACUTE OR LONG-TERM'),('TERROR', 'CUES OF ACUTE OR LONG-TERM')
lips parting slightly	('ENVY', 'PHYSICAL SIGNALS'),('HOPEFULNESS', 'PHYSICAL SIGNALS')
visible sweating	('EMBARRASSMENT', 'PHYSICAL SIGNALS'),('DEFENSIVENESS', 'PHYSICAL SIGNALS'),('CONFUSION', 'CUES OF SUPPRESSED'),('ANGUISH', 'PHYSICAL SIGNALS')
heart palpitations	('ANXIETY', 'CUES OF ACUTE OR LONG-TERM'),('NERVOUSNESS', 'INTERNAL SENSATIONS')
curling one’s toes	('IRRITATION', 'PHYSICAL SIGNALS'),('ANGUISH', 'PHYSICAL SIGNALS')
weight gain	('RESENTMENT', 'CUES OF ACUTE OR LONG-TERM'),('LONELINESS', 'CUES OF ACUTE OR LONG-TERM')
shoulders that curl over the chest	('REMORSE', 'PHYSICAL SIGNALS'),('ANGUISH', 'PHYSICAL SIGNALS')
speechlessness	('ELATION', 'CUES OF ACUTE OR LONG-TERM'),('EMBARRASSMENT', 'PHYSICAL SIGNALS')
increased swallowing	('DESIRE', 'PHYSICAL SIGNALS'),('DREAD', 'PHYSICAL SIGNALS')
wide eyes	('PARANOIA', 'PHYSICAL SIGNALS'),('UNEASE', 'CUES OF SUPPRESSED')
a racing heartbeat	('PARANOIA', 'INTERNAL SENSATIONS'),('AMAZEMENT', 'CUES OF ACUTE OR LONG-TERM')
increased thirst	('ANXIETY', 'INTERNAL SENSATIONS'),('UNCERTAINTY', 'INTERNAL SENSATIONS')
a hanging head	('HURT', 'PHYSICAL SIGNALS'),('RESIGNATION', 'PHYSICAL SIGNALS')
raised body temperature	('ANNOYANCE', 'INTERNAL SENSATIONS'),('IRRITATION', 'INTERNAL SENSATIONS')
leaning away	('WARINESS', 'CUES OF SUPPRESSED'),('DEFENSIVENESS', 'PHYSICAL SIGNALS')
shaking the head	('REGRET', 'PHYSICAL SIGNALS'),('RELUCTANCE', 'PHYSICAL SIGNALS'),('DOUBT', 'PHYSICAL SIGNALS'),('SHAME', 'PHYSICAL SIGNALS'),('DEFEAT', 'PHYSICAL SIGNALS'),('DEFEAT', 'CUES OF SUPPRESSED'),('DEFENSIVENESS', 'PHYSICAL SIGNALS'),('FRUSTRATION', 'PHYSICAL SIGNALS'),('SCORN', 'CUES OF SUPPRESSED'),('SKEPTICISM', 'PHYSICAL SIGNALS'),('AMUSEMENT', 'CUES OF SUPPRESSED')
lifting the chin	('HURT', 'CUES OF SUPPRESSED'),('WARINESS', 'PHYSICAL SIGNALS')
rubbing the back of the neck	('ANXIETY', 'PHYSICAL SIGNALS'),('DOUBT', 'PHYSICAL SIGNALS'),('IRRITATION', 'PHYSICAL SIGNALS'),('EMBARRASSMENT', 'PHYSICAL SIGNALS'),('NERVOUSNESS', 'PHYSICAL SIGNALS'),('AGITATION', 'PHYSICAL SIGNALS')
thrusting the chest out	('ELATION', 'PHYSICAL SIGNALS'),('DETERMINATION', 'PHYSICAL SIGNALS'),('INSECURITY', 'CUES OF SUPPRESSED')
an expanding feeling in the chest	('RELIEF', 'CUES OF ACUTE OR LONG-TERM'),('EAGERNESS', 'INTERNAL SENSATIONS')
keeping silent	('FEAR', 'CUES OF SUPPRESSED'),('RESENTMENT', 'CUES OF SUPPRESSED')
a high chin	('PRIDE', 'PHYSICAL SIGNALS'),('ANGER', 'PHYSICAL SIGNALS'),('FRUSTRATION', 'PHYSICAL SIGNALS')
a slow smile that builds	('DESIRE', 'PHYSICAL SIGNALS'),('CURIOSITY', 'PHYSICAL SIGNALS')
a racing pulse	('LOVE', 'INTERNAL SENSATIONS'),('TERROR', 'INTERNAL SENSATIONS')
impatience	('ANXIETY', 'PHYSICAL SIGNALS'),('DESIRE', 'MENTAL RESPONSES'),('UNEASE', 'MENTAL RESPONSES'),('EXCITEMENT', 'MENTAL RESPONSES')
whistling or humming	('SATISFACTION', 'PHYSICAL SIGNALS'),('PEACEFULNESS', 'PHYSICAL SIGNALS')
clearing the throat	('EMBARRASSMENT', 'PHYSICAL SIGNALS'),('SKEPTICISM', 'PHYSICAL SIGNALS'),('NERVOUSNESS', 'PHYSICAL SIGNALS')
frustration	('ENVY', 'MENTAL RESPONSES'),('SKEPTICISM', 'CUES OF ACUTE OR LONG-TERM')
a bent spine	('EMBARRASSMENT', 'PHYSICAL SIGNALS'),('INSECURITY', 'CUES OF ACUTE OR LONG-TERM')
cheeks that burn	('SHAME', 'PHYSICAL SIGNALS'),('DEFEAT', 'PHYSICAL SIGNALS')
