unhealthy obsession with the rival	NP
moving away	VP
being non-responsive during a group discussion or debate	VP
unhurried relaxed movements	NP
unkind thoughts toward the target	NP
offering a gift favor or boon of appreciation	VP
a quiet voice offering one-word responses	NP,VP
swinging or tapping one’s foot to an easy beat	VP
the belief that one deserves pain	NP
laughing so hard it becomes soundless	VP
expression blanching going pale	NP,VP
clammy hands	NP
a relaxed posture	NP
going for a walk or leaving the situation in hopes of gaining a clear head	VP
quick heartbeat	NP
confining a laugh to a snort	VP
sound of heartbeat thrashing in the ears	NP
darting eye movements	VP
a smile that has a genuine build and lights up the face	NP
contentedly taking more time to complete tasks	NP,VP
shoulders slumping or curling forward	NP
the feeling of being taller bigger stronger	NP
weaving hands into the hair and pulling	VP
snapping at others or adopting a defensive tone	VP
constant texting back and forth	NP
list-making	NP
visible vein throb	NP
assuming a pose that draws attention to one’s best attributes	VP
watering eyes that display an inward focus	NP
difficulty eating and sleeping	NP
displaying affection with friends or loved ones	VP
choosing loose clothing over tight revealing ones	VP
eyes wide and glowing	NP,ADJP
judging too quickly	VP
talking through the options aloud	VP
despondency	NP
a hand flying to the chest	NP
avoiding crowds large events or social situations	VP
gratification	NP
stiffness in the neck and jaw	NP
screaming	NP
a two-fingered salute	NP
squeezing the eyes shut	VP
a corded neck	NP
chest thrust out	NP,VP
a twitchy feeling in the extremities	NP
ringing ears	NP
coughing as one agrees or supports a doubtful decision or stance	VP
tight shoulders	NP
initiating hateful gossip setting the enemy up starting rumors	VP
drawing the limbs close to the body	VP
a steady lower-pitched voice	NP
feeling physically ill	VP
folding the arms over the stomach	ADJP,NP
glancing around uneasily	VP
mimicking others who display confidence	VP
hyper-protectiveness of personal space	NP
hands clenching briefly then releasing	NP
arms crossing the stomach in a protective huddle	NP
tearing up	VP
covering the mouth biting lips to hide a smile	VP
tightness in the chest	VP
unkind thoughts about the other person	NP
angling torso away from others	VP
fixing one’s hair and clothes to appear unaffected	VP
anxiety attacks	NP
a rapid heartbeat	NP
unwashed hair	NP
uncrossing and re-crossing the legs	VP
mentally berating a time-waster	VP
bringing up past examples when one supported the accuser or saved the day	VP
lip biting or pressing the lips together	UCP
fixating on an enemy stalking	VP
shrugging	NP
a strong handshake	NP
quiet answers to questions	NP
a hardening or clenching stomach	NP
mirroring the object’s movements if a person	NP,NP
feeling heavy or numb	VP
taking up a task or chore to pass the time	VP
irrational worries	NP
being the first to speak	VP
strong hygiene and personal grooming	NP
looking down unable to meet someone’s eyes	VP
tingling fingers and toes	VP
discomfort in close spaces	NP
blowing out a series of short breaths to gain control	VP
strong posture	NP
pressing the lips together to keep from speaking	VP
taking inappropriate action or risks	VP
a slow disbelieving head shake	NP
a jolt through the body	NP
inhaling deeply through the nose then exhaling through the mouth	VP
a walk that accelerates into a sprint	NP
pointing a finger while confronting	VP
a thickening voice	NP
interrupting	VP
acting noncommittal interesting idea or that’s something to think about	VP
increased heartbeat and pulse	NP
squinting	VP
mounting frustration that causes thoughts to blank	NP
relaxing one’s posture	VP
clutching at oneself elbows pressed to the sides	VP
hot eyes and cheeks	NP
reaching out to throttle hit or cause pain	VP
leaning back creating space	VP
apathetic toward goals desires or upcoming events	ADJP,NP
looping the thumbs in the front pockets while standing	VP
not engaging in further conversation	RB,VP
minimizing another’s compliments	VP
huddling crouching	NP
mentally berating oneself over an action or poor decision	VP
releasing an appreciative sigh	VP
putting on a smile	VP
making eye contact with others confidence	VP
flinging out the arms and legs taking a wide stance	VP
revisiting the hurdles leading to this moment	VP
a chest that caves in	NP
clasping one’s hands together	VP
catlike stretches	NP
criticism	NP
swearing	NP
a hand flap that dismisses the person or their idea	NP
buying gifts for others or offering tokens of kindness	VP
throat clearing swallowing	NP
clutching at oneself	VP
body collapsing in on itself	NP,VP
shaking all over	VP
falsely belittling or minimizing the attributes of the desired advantage or object	VP
leaning in or forward	VP
veiled anger or light sarcasm	NP
demanding those with influence do something to change the outcome	VP,VP
face turning ashen white pallid	VP
clutching oneself gripping the elbows rubbing the arms	VP
weak muscles	NP
covering the mouth	VP
wrist twisting	NP
teeth chattering	NP
actively listening for something	VP
yelling arguing	VP
gossiping with others running a person down for their choices or ideas	VP
a shake of the head	NP
daydreaming about people one would like to have relationships with	VP
heavy or sluggish heartbeat	NP
gripping the sides of the head as if to cover the ears	VP
a desire to carry out a vendetta via vandalism theft etc	NP
not thinking about it putting it off to savor later	RB,VP
crumpling onto a chair or sofa	VP
time feels like it’s slowing down	NP,VP
a shaky voice	NP
sudden explosions over seemingly little things	NP
willingness to escape by any means	NP
blank features	NP
a need to dominate or control	DT,VP
fearing that something will happen to screw things up	S,VP
tapping a pencil against a notepad or table	VP
clutching a token that is the focal point for the emotion	VP
hints about being busy or overly stressed	NP
shifting from foot to foot	VP
a quick exhale through the nose a snort	NP
lowering one’s head	VP
anger at oneself for freezing up	NP
brows pulling in	VP
adrenaline rushing through the body	VP
fanning oneself	VP
squealing hooting yelling	VP
swallowing hard	VP
asking questions who what when where and why	FRAG
cutting people off when they speak	VP
anxiously muttering to oneself	VP
positive self thoughts	NP
being unnerved by annoying tics loud breathing pen clicking	VP
a flash of anger when the rival is mentioned	NP
palms hidden stuffed into pockets held behind the back	NP,VP,VP
bouncing a foot	VP
wetting the lips	VP
drumming one’s feet against the floor	VP
flinching jerking back	VP
purposely closing the eyes as if to process	VP
changing the topic or diverting attention	VP
a herky-jerky walk	NP
shame	NP
sarcasm so you just happened to be near when my car’s tires were slashed huh	VP
copious sweating	NP
chest bumping with others	NP,VP
a bobbing adam’s apple thick swallows	NP
erratic thought processes irrational fears	NP,VP
going for a walk	VP
preening fussing with clothing checking oneself in the mirror	VP
gossiping	VP
minutely shaking the head	VP
a desire for everyone to experience such peace	NP
lifting the eyebrows	VP
collapsing	VP
begging for forgiveness	VP
crying wailing begging for help	VP
a bent neck	NP
offering false cheer a weak smile	VP
smiling grinning	NP
an uncomfortable dry throat	NP
pressing the lips tight to keep from smiling	VP
congratulating or offering praise	NP
offering a “thumbs-up”	VP
turning away from the cause of the fear	VP
acting in ways that push the limits of endurance	VP
bearing the teeth	VP
folding the hands	VP
gripping a fistful of shirt at the chest level	VP
waving a hand	VP
feigning interest in something else	VP
pouting children	NP
lifting hands up and then letting them fall	VP
lips pressing into a white slash	NP,VP
a pounding in the ears	DT,VP
applauding in a deliberately false fashion	VP
twitching hands	NP
complaining	VP
compressing the lips while someone else speaks	VP
skin tightens crawls	NP,VP
a yearning look and saying i love you	NP
agreeing only to avoid a confrontation	VP
a tight chest	NP
a voice that hardens over the course of an argument	NP
a ragged appearance	NP
keeping at a safe distance	VP
straining to hear shushing others to be quiet	VP
starting a sentence with the word well…	VP
drawing knees up to the body’s core	VP
cutting scratching or other self-destructive behaviors	VP
pressing hands against the stomach	VP
feet pointing forward	NP
softened features that imply calm	NP
blaming others	VP
wagging a finger berating another for their accusations	VP
breathlessness	NP
tingling in the chest	VP
forcing oneself to come closer	VP
sprinting or running	VP
a desire for vengeance	NP
attempting to hurt through name-calling and personal jabs	VP
an inward gaze or unfocused stare	NP,VP
an inability to speak	NP
anger bitterness	NP
increasing one’s personal space	VP
offering to avenge the offended party	VP
eyeing the exits	VP
rushed speech	NP
agreeing but without emotion	UCP
hugging one’s shoulders chin resting on the chest	NP,VP
smiling and pretending to pay attention	VP
waving off a compliment	VP
a feeling of unworthiness	NP
rushing into decisions to prove decisiveness	VP
refusing to be bought off through kindness or thoughtfulness	VP
teeth biting down on the bottom lip	NP,VP
an unmoving stance	NP
hunched shoulders	NP
feeling worthless	VP
attempting to lighten the mood with a joke	VP
clock-watching	NP
raising the eyebrows	VP
a rising antipathy toward the person responsible for the situation	NP
holding one’s head in one’s hands	NP,VP
head tilted while mentally weighing evidence	NP,VP
modesty	NP
offering a deep sigh and thoughtful expression	VP
forcing a laugh	VP
preferring to do things alone	VP
a slight chill or shiver	NP
pinching the bridge of the nose and squeezing the eyes tight	VP
a sleek walk that draws the eye catlike deliberate	NP,VP
plucking at clothing as if it chafes	VP
projecting hurtful observations i’d be embarrassed if i were you	S,VP
body and feet pointed forward	NP,VP
attempting to distract oneself in an effort to be patient	VP
a tense body on the verge of springing	NP
keeping one’s eyes down	VP
slumped shoulders limp posture	NP
poor sleep patterns	NP
sweaty hands	NP
rocking in place	VP
shoulders that quake with repressed sobs	NP
melancholy gloomy	NP
shoulders curling over chest	NP
flinching if touched	VP
the mind going to the worst-case scenario	NP,VP
uncontrollable tears	NP
wheezing breaths	NP
strong organization and preparedness	NP
chattiness babbling	NP
sitting up straight and alert	VP
audible stress in one’s voice and tone	NP
a curt nod	NP
letting out a huge breath	VP
eyes that blink infrequently	NP
tackling a task to distract cleaning waxing the car	VP
showing kinship with others involved hugging reaching for their hands	VP
a heightened need for personal distance	NP
fidgety hands that won’t settle	NP
rubbing the lips or chin	VP
steering the conversation to a different topic	VP
pushing the hair out of the face	VP
drowsiness	NP
trying not to focus on the rival	VP
weakness in the legs a sudden need to sit down	NP,NP
widening eyes	NP
stuttering	NP
dragging footsteps	NP
collapsing knees giving out	VP
a shiny or rosy face	NP
casting morality and good judgment aside	NP
the need to check for danger overriding the need to hide	DT,VP
jerky head movements	NP
a voice that rises in volume or intensity	NP
muttering tearfully to oneself	VP
voicing support but with a tone that lacks enthusiasm	VP
sinking to the ground exhausted	S,VP
rubbing at one’s nose or mouth	VP
using the victim’s name in dialogue when they are present	VP
rejecting the advantage choosing to pursue another girl instead	VP
living together a committed relationship marriage	VP
arms crossing in front of the chest	NP
smirking as the subject speaks	VP
stuttering stumbling over one’s words	VP
exchanging personal effects clothing jewelry keys	NP
adopting a sullen look	VP
moving about being unable to stay still	VP
uncontrollable laughter	NP
becoming talkative	VP
mimicking confidence straightening speaking in a booming voice	VP
stroking the throat and grimacing	VP
hiding one’s hands and feet so clenching and twitching can’t be seen	NP,VP,VP
pulling glasses down and looking over the rims	VP
wishing one could alleviate the pain	S,VP
feigning disinterest	NP
shuffling back a step or two	VP
happy tears shining cheeks	NP
frequent touching of the face and lips	NP
collapsing from a perceived fright	VP
burning sensation in the chest or stomach	VP
clutching at the chest or belly	VP
a sigh conveying annoyance a huff	NP
quick high-pitched laughter	NP
reaching out to brush touch or grasp	VP
a dry throat from rushed breathing	NP
running a victory lap	VP
supporting the outcome acting like one was “in the know” all along	S,VP
taking a seat to hide the emotion	VP
dizziness a sense of vertigo	VP
footsteps that drag	NP
a desire to change the speaker’s mind or standpoint	NP
taking large deep savoring breaths	VP
bowing or curtseying	VP
notable weight loss or gain	NP
pounding one’s fists against thighs table a wall etc	NP,VP
standing with one arm holding the other at the elbow	VP
hands falling to the sides	NP,VP
an increased sense of desperation as time goes by and the situation is unresolved	S,CC,S
an unkind smile	NP
sighing	NP
speaking emphatically with finger pointing or other hard gestures	VP
asking questions requesting information	VP
suggesting that a break is needed to regroup	VP
sacrificing others or lesser goals desires and needs if necessary	S,VP
taking deep breaths in an effort to calm oneself	VP
lying about one’s feelings regarding the subject	VP
twisting the mouth a soured expression	NP,NP,DT,VP
acute senses	NP
closed body language hands up crossed arms	NP,VP
scratching compulsively	VP
drooping shoulders	NP
weakness in the muscles	NP
loose jaw	NP
words are chosen deliberately	NP,VP
throat clearing	NP
hooking a hand in the other person’s belt or pocket	VP
circles under the eyes	NP
thoughts that keep coming back to the worst possible outcome	NP
an inability to concentrate on anything else	NP
closing off all thoughts of what is happening	VP
a raised eyebrow and a see look	NP
muttering mumbling	NP
an easygoing manner	NP
asking a few token questions	VP
a choking or uncomfortable swallow	NP
eyes that appear cold dead flat	NP
retreating inward	VP
a knot in the belly	NP
an inability to find words	NP
a wandering gaze	NP
setting a time limit	VP
sitting quietly	VP
making unkind mental comparisons	VP
belittling another’s status or accomplishment	VP
waiting at a window hovering at the door or by the phone	VP
voicing the emotion over and over i just can’t believe this	S,NP,VP
scrunching oneself up in a chair or sofa	VP
becoming unaware of one’s environment or other people	VP
self-destructive addictions	NP
laying a hand on someone’s back or shoulder	VP
flushed skin	NP
singing humming chanting	VP
apologizing to others for having their time wasted by the target	VP
worry that this event could happen to anyone particularly to oneself or loved ones	VP
a flat tone of voice	NP
high adrenaline level jumpiness	NP
accelerated breathing	NP
muscles tightening in readiness	VP
a desire to verbally tear down or hurt another person	NP
talking to oneself	VP
weak knees	NP
making small jittery movements with the fingers	VP
pulling and tugging at one’s clothes as if they can make one less visible	VP
voicing surprise sorry you caught me off guard	NP,ADJP,S
organizing one’s things being prepared	VP
an ugly twist to the mouth	NP
lowering the chin to look down on someone	VP
tipping or turning the head to the side	VP
eyes that glow with inner light	NP
an empty feeling in the pit of the stomach	NP
seeking out those who shared the event	VP
speaking first thinking second	VP
forgetting appointments conversations and meetings	VP
lying about feelings	VP
warding someone or something off	VP
fists tight fingernails biting into the palms	NP,VP
sarcasm	NP
loosening belts collars and other confining clothing	VP
body posture that loosens or collapses	NP
verbalizing the pros not the cons	VP
euphoria	NP
gathering opinions on what others would do	VP
gritting one’s teeth	VP
a heaviness in the body	NP
a face that blanches	NP
carefully-masked features but eyes that betray the true emotion	NP
seeking the safety of darkness an exit etc	VP
body odor	NP
a desire to go unnoticed	NP
shunning other people who are not of like mind	VP
walking away to regain composure	VP
postponement of residual loss or pain until a later time	NP,PP
stuttering stammering	NP
head resting on one’s hand	VP
high pain tolerance not feeling or noticing injuries	NP,VP
future planning that centers around the love interest	NP
approaching people with ease	VP
subdued laughter	NP
turning the torso shielding it	VP
experiencing to a lesser degree the same physical sensations felt during the past event	VP
speaking in a flat voice	VP
the body sagging while seated lacking tension	NP,VP
holding the hands loosely behind the back	VP
doing a double take	VP
listing the possible consequences	VP
brows drawing closer face tightening	NP
anxiety	NP
a parting hug lasting longer than normal	NP,VP
a smile or grin that cannot be contained	NP
accusing innocent people of planning or carrying out mischief	VP
distancing oneself from others	VP
rubbing someone’s back	NP,VP
seeking out a distraction or diversion	VP
moaning	VP
shoulders pushing back	NP
cupping an elbow with one hand while tapping the lips with the other	VP
guilt	NP
pain in chest	NP
a satisfied sigh	NP
not taking physical care of oneself	RB,VP
interest in whatever’s going on	NP,VP
an inability to relax or smile	NP
using broken sentences or trailing off while speaking	VP
avoiding direct eye contact	VP
disinterest in former hobbies or passions	NP
taking advantage of a distraction watching a movie tv	VP
perfectionist tendencies to balance the source of shame	NP
an open mouth the tongue pushing slightly forward	NP,NP,VP
a flush that creeps across the cheeks	NP
offering fake platitudes interesting or well that’s good then	VP
sipping a drink or taking a bite to eat	VP
stubbornly adhering to one’s beliefs no matter how outlandish	FRAG
laugh lines	NP
arguing with the suspect	VP
using a carefully controlled tone	VP
turmoil at having negative feelings	NP
talking behind someone’s back gossiping	VP
imagining what will happen	VP
walking away to gain composure	VP
staring the target down	VP
fight-or-flight reflex kicking in	NP
explaining that one is not in denial	VP
anger at the unfairness or injustice	NP
a set jaw	NP
muscles tightening head drawing back stiffly	NP,VP
verbal disagreement	NP
a shifting feeling near the heart a pang	NP
a stony expression	NP
choosing the middle not the sides be it a couch or a room	VP
a gaze that darts to a symbol of hope a friend in the know a table of judges	DT,VP
nodding or agreeing to avoid attention	VP
bouncing from foot to foot	VP
tugging at a tie collar or scarf	VP
a knotted belly	NP
flicking through a magazine without reading it	VP
tuning out distractions in order to fixate on the object or want	VP
poor conversation skills	NP
making excuses	VP
a playful pinch nudge or shove	NP,VP
attempting to reason through facts not emotion	VP
negative thought patterns	NP
a high voice	NP
walking away	VP
an inability to stay still	NP
a finely-tuned sense of observation	NP
the mind racing searching for answers	NP,VP
repeating the word no	VP
hiding a joyous expression with one’s hair	VP
pulling or prodding others to hurry up	VP
needing to leave excusing oneself cutting a meeting short	VP
making jokes at another’s expense	VP
acting like giving in was a choice not the only option	VP
a desire to escape the sadness through sleep drink companionship	NP
narrowing eyes squinting	NP,VP
a sad or serious demeanor	NP
unsafe sexual practices	NP
body odor cold sweats	NP
making decisions then second-guessing oneself	VP
a pained expression	NP
mentally encouraging oneself to succeed	ADVP,VP
attempting to hide covering the head ducking one’s chin	VP
adrenaline causing alertness	VP
asking pointed questions	VP
minimal speaking one-word answers shaking or nodding the head	NP,NP
shifting from casual conversation to pointed questions	VP
forcing oneself to sit still	VP
a downturned mouth	NP
eyes brightening as memories are recalled	NP,VP
voicing wonder i can’t believe it or look at that	NP,NP,VP
letting out an uncontrollable cry sob or whimper	VP
ignoring something being handed over a file business card etc	VP
a steady even tone	NP
gripping something knuckles going white	VP
bending kneeling or squatting to get closer	VP
replaying the humorous event	VP
turning one’s back to the source	VP
hands curling around one’s middle	NP
hollowed cheeks	NP
eyes that look dark or serious	NP
shaking the head in disapproval but not saying anything	VP
obsession with the suspect	NP
acting skittish around people	VP
sabotaging another’s projects or actions out of a sense of being wronged	VP
gulping food down in order to escape more quickly	VP
becoming closed-minded refusing to listen	VP
closing the eyes	VP
a softened voice or tone that may contain wonder	DT,VP
bitterness at watching how others respond to the rival	NP
difficulty making friends	NP
eyes darting for an exit or escape flight response	NP,ADJP
dragging others into the situation for support	VP
strain or soreness from tense muscles	NP
a weighted chest	NP
a knowing grin	NP
reminding someone of a past mistake to rub it in	VP
mouth snapping shut	NP,VP
brushing off compliments or putting oneself down	VP
blinking	ADVP
frowning	NP
lips pressed flat	NP,VP
chest pain	NP
clumsiness	NP
poor eating habits	NP
bottom lip or chin trembling	NP
screaming crying blubbering	VP
weighing the pros and cons	VP
offering a firm handshake	VP
a skewed sense of time	NP
joking to lighten the mood or distract others from the truth	VP
anxiety attack	NP
pressing the lips into a fine line	VP
offering small touches to connect	VP
a high-pitched voice	NP
withdrawing from others	VP
shrugging half-heartedly	NP
encouraging others to speak up against the target	VP
fingering a necklace	VP
scouting for exits when entering a room	VP
holding hands behind the back gripping one’s own wrist	VP
uncontrollable crying bouts	NP
deflecting attention	VP
apologizing for one’s lackluster reaction citing mixed feelings	VP
scratching one’s neck or cheek	VP
scratching at the skin picking or biting at nails	VP
complimenting	NP
waving the arms using grand gestures	VP
mouth going dry	NP,VP
tears streaming down the face	NP
seeking to hurt through a “low blow” comment	VP
a desire to do anything to repay	NP
biting at lips	VP
rubbing the chin	VP
body posture that perks up	NP
using books the internet and tv to escape	VP
subdued or delayed reactions	NP
putting a hand over the face closing the eyes	VP
a tiredness that is fulfilling rather than exhausting	NP
smoothing or stroking one’s own hair as a soothing gesture	VP
a lessened need for worldly goods	NP
intense concentration on something or someone else	NP
pressing one’s hands to the stomach	VP
fingers loosely clasped in one’s lap	NP
decreased coordination and clumsiness	NP
becoming non-reactive to stimulus or noise	VP
high blood pressure	NP
skin tightening crawling flesh sensation	NP
crossing the arms over one’s chest	VP
swaying or rocking on one’s feet	VP
head up alert	VP
wrinkles and sagging around the eyes and mouth	NP
scratching one’s jaw	VP
acute listening and observation	NP
soreness in the throat and lungs	NP
indulging in alcohol drugs or chain smoking to take the edge off	VP
a slow walk	NP
catty behavior	NP
a clenched jaw gritted teeth	NP,VP
rubbing a hand through the hair	VP
blinking less as if worried one might miss something	ADJP,SBAR
confusion	NP
rocking on one’s heels pretending to study the floor	VP
pauses ums or other conversation fillers	VP
shutting down refusing to make a decision	VP
indecision	NP
crying sobbing	NP
posture “perks up” as awareness increases	NP,VP
a heart that seems to freeze then pound	NP
laughing or making jokes meant to disarm	VP,VP
changing one’s stance shifting weight or position	VP
clumsiness bumping into things knocking things over	VP
a slight heaviness or quiver in the stomach	NP
turning away and bursting out in laughter	VP
biting one’s lip	VP
staring at nothing for an overlong moment	VP
a fluttery feeling in the chest	NP
leaning back or away from the source of discomfort	VP
talking over one another babbling	VP
heavy self-medicating or drinking	NP
smoothing down clothing	VP
not caring what others think or feel	VP
watching from a distance	VP
choosing to spend time with positive or like-minded people	VP
needing advice or instruction on what to say or do	VP
tilting the head to the side	VP
licking or sucking on the bottom lip	VP
laying in bed with no motivation to get up	VP
a string of broken relationships	NP
repeating words over and over wow or i can’t believe it	NP,ADVP,VP
an inability to move on	NP
thoughts of self-harm	NP
self-destructive behaviors out of the belief that one does not deserve happiness	NP,PP
drug use	NP
a headache	NP
pulling up a collar to cover the mouth and nose	VP
grimacing or swallowing	VP
eyes shining locked on the source of relief	NP,VP
irrational thinking poor judgment	NP
a furrowed brow	NP
running away with no destination in mind	VP
a lack of intimacy with others	NP
embracing others	VP
gratitude	NP
raised eyebrows	NP
heart thudding dully in the chest	NP,VP
shielding the body angling away from those bearing witness to shame	VP
physical touches to reassure a clap on the back or shoulder	NP,VP
looking elsewhere while listening so as not to make the other male uncomfortable	VP
tense arms shoulders or face	NP
stilted halting dialogue	NP
covering the mouth with a hand eyes wide and shining	VP
a smile that appears tight	NP
gritting the teeth	VP
a condescending smile	NP
beads of sweat on the lip or forehead	NP
legs wide apart	NP
weight loss or gain	NP
a sudden stiffening posture rigid muscles	NP,NP
increased sexual activity	NP
a playful swat at a friend for causing the surprise	NP
faintness	NP
asking questions one knows the answers to in an effort to discern another’s intent	S,NP,VP
initiating contact	NP
elbows pressing into the sides making one’s body as small as possible	NP,ADJP
raising the voice	VP
hands dropping to one’s sides	VP
clapping someone on the back overplaying closeness or friendship	VP
attempting to hold back whimpers or moans	VP
bouncing a knee while sitting	VP
mumbling muttering	NP
clenching one’s teeth	VP
patting pockets or digging in a purse looking for something lost	VP
lines in the face a slack expression	NP
clumsy attempts to comfort a weak smile an awkward hug	NP
nose running sniffing	NP
a dismissive nod or glance	NP
a quick false smile	NP
a mind that is clearly distracted	NP
quick breaths	NP
acting like the life of the party	VP
pointed or even rude questions	NP
a loss of appetite	NP
a negative outlook	NP
looking down or away to hide one’s expression	VP
rubbing one’s upper arms for comfort	VP
repeating back what was said as a question	VP
dulled awareness sitting in an uncomfortable position without feeling it	VP
intensely concentrating on something else actively ignoring others	VP
retreating internally to cope shutting the world out	VP
heightened senses	NP
tightness in the eyes or expression	NP
wishing harm	NP
ignoring phone calls or visitors	VP
weaving in place a lack of balance	VP
an expression of supreme confidence a glow	NP
swearing or shouting	NP
mentally reducing high expectations	ADVP,VP
shoulders dropping or slumping	NP,VP
spinning around trying to spot any and all danger	ADJP
good-natured shoving and pushing	NP
a hard smile	NP
still hands and feet	NP
awkwardly mirroring the behavior of others	NP,VP
a loosening of the bladder	NP
a light-hearted feeling	NP
standing solidly at the ready	VP
staring off at nothing	VP
a rumpled appearance	NP
feeling emotionally drained	VP
unkind observations	NP
visible tension in the neck shoulders and arms	NP
muscles and veins straining against skin	NP,VP
fingers retracting turning claw-like	NP,VP
spittle building up in the corners of the mouth	NP,VP
drawing breath and releasing it before speaking	VP
jealousy towards those interacting with the subject	NP
swallowing laughter	VP
using hair to hide one’s face	VP
heart attack or stroke	NP
beating someone senseless	VP
constricting lungs making it hard to breathe	VP
evaluating the subject’s manner and appearance	VP
pulling down glasses and looking over the rims with a flat gaze	S,VP
warmth radiating throughout the body	NP,VP
believing that the feelings are mutual	VP
lack of eye contact	NP
weaving slightly	VP
clamping the hands in the lap	VP
lowering one’s voice when speaking	VP
a voice that cracks with emotion	NP
mind tries to discern possible danger	NP,VP
an aversion to noise crowds and stressful situations	NP
staring blankly or emotionlessly	VP
displaying a wide grin	VP
a scathing tone	NP
purposely adopting a languid pose	ADVP,VP
picking fights verbal or physical	VP
heavy jerky movements	NP
shaking the head repeatedly	VP
imagining what could happen	VP
shakiness	NP
raising one’s palms to the sky and looking up	VP
leaning forward	VP
anger at being touched or addressed by the target	NP
obsessing about the embarrassing event reliving it	VP
a tight smile that doesn’t reach the eyes	NP
clouded judgment	NP
hallucinations anxiety attacks phobias psychosis	NP,VP
hoarding tendencies	NP
pretending to disengage because of boredom	VP
a desire to retreat and go somewhere quiet to think	NP
panic attacks	NP
squinting eyes	VP
cringing flinching jumping at sounds	VP
bodily cravings of being touched by the object person	NP
reassuring others	NP
hallucinations	NP
verbalizing disappointment or denial	VP
a thick throat	NP
shaking out the hands	VP
thinking ahead to what might happen	VP
a mouth that curls with dislike sneering	NP
a frozen smile	NP
quivering twitchy muscles	VP
baring the teeth slightly	VP
making joking observations	VP
a thickness in the throat signaling the onset of tears	NP
taking opportunities or meeting challenges to prove one’s worth	VP
facing danger head-on	VP
offering a wave of thanks	VP
mentally replaying past events	NP
laying a hand over the heart	VP
tightness in the jaw and facial muscles causing discomfort	NP
short-temperedness	NP
maintaining an even tone	VP
shoulders are lowered and loose	NP,VP
asking questions to discern the root issue before things turn bad	VP
skin problems such as eczema and acne	NP
a beaming face	NP
anxiety disorders	NP
subdued personality	NP
slight tenseness in the muscles	NP
feigning disinterest by adopting a loose and relaxed posture	VP
difficulty committing fully to any action	NP
appearing unaffected by what others think	VP
falling to the ground rolling on the floor	VP
wanting to drink in the moment to remember this feeling forever	VP
uncertain almost drunken steps	NP
a stern or serious expression	NP
pain in the jaw from clenched teeth	NP
trembling muscles	VP
mimicking body language of the subject	VP
blushing when noticed or spoken to	VP
toes curling up	NP,VP
breaking out into a run	VP
feeling ultra-awake rejuvenated by adrenaline	VP
engaging in self-mutilation as a release	VP
examining or pretending to consider other objects	VP
jumping up and down	VP
snooping or sneaking about to satisfy the need to know	VP
speaking without thought often leading to regret	VP
sharing a look or wink with another	VP
leaning in hand on one knee	VP
wanting to be surrounded by supportive loved ones	VP
self-loathing berating oneself anger disgust	VP
scratching at one’s cheek or temple	VP
talking over people controlling conversations	VP
watching or observing from afar	VP
a loud voice bragging full of bluster	NP
tucking the hands behind the elbows	VP
turning inward withdrawing	VP
rushing blood	VP
putting up a false front as if everything is okay	VP
plummeting self-esteem	VP
aches and pains	NP
playing what if to understand the repercussion of a situation	VP
freezing feeling rooted to the spot	NP,VP
verbalizing thoughts and feelings without hesitation	VP
a loss of coordination	NP
touching one’s mouth or face	NP
sneaking or spying	VP
an inability to commit to or focus on anything else	NP
hooking thumbs into one’s belt loops thrusting the pelvis forward	VP
feeling directionless	VP
body angling away from suspect	NP,VP
a beaming face strong color and sheen	NP
slumping rather than sitting straight	VP
drawing back making oneself smaller	VP
lips pressing tight	NP,VP
non-responsiveness to others even family	ADJP,NP
waving a hand as if something doesn’t matter	VP
a smirk or eye roll	NP
sitting then standing then sitting again	VP
rubbing the heel of a palm against chest	VP
dredging up history trying to understand how it led here	VP
trembling lips and chin	VP
jerky movements squirming	NP,VP
causing self-harm and not noticing cuts bruises etc while trying to escape	VP
laying a hand on one’s heart then gesturing to a person or group	VP
the sensation of things moving too quickly to process	NP
crying or calling out in release	VP
pulling stunts or pranks to regain attention	VP
a fast-paced stride	NP
shuffling creeping or edging closer	VP
stepping back	VP
an intuitive feeling that something isn’t right hairs standing up prickling of skin	NP
asking are you sure or what if questions	NP,VP
jumping to conclusions	VP
stiff walking the knees locking	NP
a desire to maintain a positive status quo	NP
pressing hands against one’s cheeks	VP
scrunching up the face and then releasing trying to regain calm	VP
curling the arms over the head	VP
cocking one’s head to the side	NP,VP
quickening breath or breathlessness	VP
delaying verbal support	VP
fighting with no thought for one’s own safety	VP
tapping the leg to settle nerves	VP
responding with whatever or so	VP
slapping a hand against the table	VP
stiff neck strained forearms	NP
arms drawing back to the body core in a protective flinch	NP
stooped posture	NP
making promises	VP
a jutting jaw	NP
using a purse or jacket to create a shield	VP
pressing hands to one’s temples	VP
reassuring others of loyalty commitment etc	VP
gently touching memorable items a baby blanket wedding invitations	VP
giving a small yelp	VP
arms hanging at the sides	VP
breaths coming coarser faster	NP
ache in the back of the throat	NP
throwing hands up in an “i give up” gesture	S,VP
weakness in legs	NP
pleading abasing or disregarding personal worth or pride	VP
espousing far-out beliefs and opinions	VP
a pained stare	NP
constant motion applying lip gloss texting people rooting in purse	NP
masking nostalgia with practicality i kept his toys so he could give them to his kids	S,NP,VP
clasping the hands together	VP
a rolling or fluttery feeling butterflies in the stomach	NP,VP
flapping hands	VP
holding one’s head with the hands	NP,VP
a feeling of connection to life	NP
spreading the fingers out in a fan against the breastbone	VP
spinning away in a huff	VP
holding one’s palms up and out	VP
asking for a person to review the pros and cons again for clarity	VP
throwing the hands up in a gesture of surrender	VP
going quiet or non-responsive	VP
an intense need to flee the source	NP
a bobbing adam’s apple	NP
taking a slight step back	VP
holding oneself tight	VP
gritty or dry eyes from lack of sleep	NP
a deep weighted sigh	NP
increased physical contact becoming touchy-feely	NP
a dry mouth	NP
breaths that hitch or briefly stop	NP
nodding slowly	VP
a flinty gaze	NP,VP
verbalizing responsibility for what happened	VP
covering the face with the hands	VP
letting the head fall back	VP
a tapping heel	NP
a fake smile	NP
an understanding nod	NP
false bravado	NP
dry washing the hands	VP
head tilting back gaze looking up	NP,VP
careful consideration of friendships purchases places where one is seen	NP
openly challenging another’s logic or standpoint	VP
clutching an item to the chest book binder purse	VP
heart that feels “full”	NP
making oneself appear smaller	VP
a lack of eye contact	NP
stiff neck cords standing out	NP,VP
acting interested in something else	VP
belittling comments that remind the target who has the upper hand	VP
a slight smile	NP
a blank look a slack expression	NP
citing that one is not the ideal candidate to make the choice	VP
sucking the cheeks in	VP
a flushed face	NP
refusing to be persuaded	VP
“drunken” behavior weaving staggering	NP,VP
giving a distracted nod to what’s being said	VP
shaking the head voicing denial	VP
mental fatigue from not getting enough sleep	NP
making token acknowledgements to those who played a part in an outcome	VP
body quaking	NP
hoping for an interruption to delay answering	VP
assuming the worst-case scenario	VP
agreeability to whatever is suggested	ADJP
making excuses if reaction is noticed	VP
stomach hardening nausea	VP
grinding one’s teeth	VP
an excited flutter in the belly	NP
shooting glances at the suspect	VP
cutting the eyes toward the source	VP
laughing too loudly or at odd times	VP
an expression that appears pained	NP
an inability to see where the future might go	NP
feverish over-bright eyes	NP
pulling down a shirt hem covering gesture	VP
rubbing one’s hands on pant legs	VP
jerkiness in the legs leaping back	VP
uncertainty about what to say	NP
friendly demands tell me show me let’s go	NP,VP
vigorous head shaking	NP
a fluttering in the stomach a feeling of emptiness	NP
disdain for those who are unworthy	NP
studiously not looking at the source	ADVP,RB,VP
hands clenching into fists	NP
gasping for air	VP
obsessive behavior stalking making a plan to acquire the advantage	NP
obsessive clock-watching	NP
praising group accomplishments as a way to remind people of one’s own involvement	VP
changing the topic in any way possible	VP
fighting or arguing with the envied one to release frustration	VP
mental fuzziness distraction daydreaming	NP
running hands through the hair	VP
a gaze that bounces from place to place	DT,VP
wanting to expose the subject’s ignorance	VP
self-doubt	NP
shaking head and closing the eyes	VP
dropping or spilling things	VP
thoughts of violence	NP
giving comfort through gifts plying a person with food or attention	VP
body shielding if holding onto an object	NP,VP
leaning back arms crossed	S,VP
not caring what others think a lack of self-consciousness	VP
hands rushing toward the mouth to cover	NP
not meeting the requester’s eyes	RB,VP
fixating one’s thoughts on the subject	VP
struggling to find the right words	VP
a sense of destiny of belonging together	NP
kicking at nearby objects	VP
telling the speaker to move on and get to the point	VP
grimacing sneering frowning	VP
raw nerves and skin	NP
drawing the mouth into a straight line and biting the lip	VP
clapping vigorously	VP
a feeling of connection and love	NP
jittering a foot against the floor	VP
a sense of calm	NP
blushing	NP
an inability to sleep	NP
feeing safe and whole when together	VP
an inability to form words	NP
refusing to respond or engage	VP
tears or heat behind the eyelids	NP
fight response a rush attack using anything at hand to hit or destroy	VP
waving dismissively	VP
intimacy	NP
wandering thoughts	NP
a darting gaze	NP,VP
fake swooning	NP
a relationship categorized by negativity passive-aggression and criticism	NP,VP
skimming fingertips along the jaw line	VP
short-temperedness irritability	NP
phrasing questions in a positive way to make the other person feel better	VP
limp hands and arms	NP
calling friends and loved ones to tell them about an accomplishment	VP
staring at one’s palms as if they hold the answers	VP
picking at lint scratching at cuticles etc to show that interest is lacking	VP
closing or curling one’s hands inward	VP
berating thoughts	NP
a swinging foot that suddenly goes still	NP
widening of the eyes	VP
eyebrows drawing together	NP
hands clutching at stomach	VP
staying out of the subject’s proximity	VP
assuring others that everything is under control	VP
gaze ping-ponging avoiding direct eye contact	VP
enthusiastic waving	NP
a clenched jaw	NP
scowling	NP
runny nose	NP
shoulders curling forward caving the chest in	NP,VP
tossing and turning in bed an inability to sleep	VP
appreciation for the little things	NP
looking down or away	VP
making a joke to alleviate tension or lighten the mood	VP
a heightened sense of self-importance	NP
sharing hopes and dreams becoming emotionally vulnerable	VP
a desire to be with loved ones or friends	NP
asserting mental restraint to avoid snapping	VP
covering face with hands	VP
stuttering or stammering	VP
fiddling with jewelry or other items	VP
forgetting words being unable to articulate thoughts	VP
bouncing lightly on the toes	VP
seeking interaction online rather than in person	VP
an impatient huff	NP
watching the rival furtively privately	VP
polite verbal opposition	NP
slumping posture	NP
clasping another’s hand or forearm	VP
hunching over as if choking down a sob	VP
pretending to laugh it off	VP
a desire to be near or to make physical contact	NP
flicking a hand in front of one’s nose as if to get rid of a bad smell	VP
sagging against a door or wall reaching out to steady oneself	VP
face going slack and paling slightly	VP
a curling lip	NP
seeking ways to make a loved one proud	VP
a pained keening	NP
a voice devoid of emotion deadpan	NP
repeating the punch line or a select word to spur more laughter	VP
shaking trembling shivering	VP
overcompensation in other relationships	NP
increased sweat particularly on the hands	VP
slow languid movements	NP
clammy skin	NP
repeating the same things over and over	VP
becoming excessively resourceful or helpful to make up for earlier failure	VP
meaningless interaction with others	NP
seeking out second chances fawning begging following others to regain self worth	VP
punching or ripping apart something soft	VP
stuttering growing flustered	VP
panic disorders	NP
a slow disbelieving shake of the head	NP
a quick erratic pace	NP
reaching out or touching	VP
tucking in the upper lip	VP
a desire to move closer or touch	NP
a display of violence kicking grabbing shaking or destroying something in release	NP
a feeling of being able to conquer the world	NP
pressing lips together	VP
splotchy skin	NP
using the time to run an errand or complete a task	VP
stretching the arms out wide	VP
a comfortable warmth in the face	NP
a shaky soft halting or disbelieving voice	NP
a chin that juts sharply	NP
two-faced behavior	NP
reacting defensively	VP
a tightening chest	NP
embracing the love interest’s friends as one’s own	VP
a trembling chin	NP
pulling in a deep breath	VP
thumping heartbeat	NP
jiggling tugging or tapping the earlobe	VP
a hand covering one’s mouth	NP
wincing as others rally behind a weak solution	VP
upset stomach	NP
arguing or questioning	VP
looking forward to a well-earned rest	VP
defeatist thoughts about oneself	NP
ignoring pain stress or any outside elements	VP
keeping one’s hands free	VP
a hand casually anchored on the hip	NP
a wide smile	NP
pushing one’s glasses up	VP
holding onto a comfort item a special piece of jewelry a picture	VP
difficulty completing a task	NP
a slack expression wet dull eyes	NP,VP
finding little day-to-day joy	VP
eyes dull lifeless	NP,ADJP
fainting or swooning	NP
fantasizing harm or the downfall of another	NP
bitten nails bleeding quicks	NP
grunting one-word answers	VP
rubbing at an eyelid or brow	VP
changing the topic	VP
tilting the head to the ceiling and letting out a heavy sigh	VP
claiming that one’s calm demeanor is simply tiredness	VP
covering the face	VP
a tight jaw	NP
saying how could you as an accusation	VP
a shy confident radiant or cocky smile	NP
losing all inhibitions	VP
a desire to get away from the person making the request	NP
rising blood pressure	VP
a desire to shut the speaker up	NP
covering up pulling a jacket tighter holding one’s elbows	VP
using boisterous movements to draw attention to oneself	VP
muttering under the breath or cursing	VP
lifting someone up or swinging them around	VP
living vicariously through an alter ego or avatar social networking gaming	VP
falling to one’s knees	VP
going overboard in preparation dressing over-the-top etc	VP
picking fights	VP
pointless activity as a way to stay busy	NP
small steps	NP
offering compliments	VP
despairing of ever being able to change	ADJP
a pinched tension-filled expression	NP
barreling toward someone uttering a scream or war cry	VP
neglecting current duties or relationships	VP
fidgeting or tics	NP
seeking out opportunities to react violently	VP
tingling in one’s limbs	VP
trying to convince others of the suspect’s guilt	VP
hoarding pets	NP
scheming ways to acquire what another has	NP,VP
studying or gathering information	VP
a purposeful shiver or shudder	NP
a reddening face	NP
checking a cell for messages or to see the time	VP
a long low sigh	NP
wearing the same clothes day after day	VP
lifting one’s chin to expose the neck	VP
tension in the neck and shoulders	NP
restless legs crossing and uncrossing unable to stand still	NP,ADJP
a hard expression	NP
offering restitution	NP
moving toward an exit	VP
sweating	NP
contacting the authorities for help against suspected assailants	VP
flexing the fingers or arm muscles	VP
an inability to focus	NP
a lack of concentration	NP
drawing a deep breath through the nose	VP
zoning or tuning others out to concentrate on other things	VP
a desire to fade into the background and avoid notice	NP
eyes that blink too much or don’t blink enough	NP
generosity to others as a result of feeling gratified	VP
a chin that trembles	NP
demanding proof or evidence to support	VP
spontaneity	NP
mouth slackening	NP
leaning back	VP
clamping one’s hands tightly together	VP
telling jokes	VP
flinching	NP
expressing more emotion about the past than the present	VP
a series of deep breaths	NP
pointing and jabbing the air for emphasis	VP
clasping the hands together in the lap	VP
changing the topic to avoid hurt feelings or an argument	VP
flipping hair or combing fingers through it	VP
clasping hands under the chin in a prayer gesture	VP
collapsing onto a chair or bench	VP
a gaze that flicks upward	DT,VP
slapping hands against the cheeks	NP
a tight mouth as if tasting something bad	NP,ADJP
moving fidgeting pacing	VP
animated gesturing	NP
anger shock	NP
avoiding conversation	VP
feeling overwhelmed as if the room is closing in	VP
a joking tone but the voice cracks	NP
pointing one’s torso and feet toward the subject	VP
restlessness	NP
extreme pride in appearance and possessions	NP
closing eyes and squealing	NP
a trembling voice	NP
head flinching back slightly	VP
head tilting away	VP
arms crossed over the chest	NP,VP
fixating on the source of suffering	VP
showing one’s palms	VP
being driven by the belief that one has been mistreated or done wrong	VP
deepening one’s tone	VP
trying to forget the event	VP
desiring to spread joy and make others feel good	VP
rubbing absently at the arms	VP
cold eyes	NP
keeping one’s hands out of the pockets	VP
taking deep breaths savoring the moment	VP
doubting oneself a lack of confidence	VP
eyes that fill with tears	NP
stiff posture rigid muscles a corded neck	NP
ducking the chin to hide the neck	VP
lingering at the edge of a group or event	VP
whispering no or cursing under the breath	VP
shakiness in the limbs	VP
loss of motor control	NP
heat that radiates through the chest	NP
passive-aggressive comments	NP
fantasizing about the advantage	VP
following the suspected person	VP
a desire to be included wanted	NP
making a tsking noise or murmuring regret what a shame	VP
clamping the hands to the chest	VP
tilting the chin down and frowning	VP
acknowledging the object and complimenting it	VP
baring one’s teeth	VP
mentally running through everything known about the situation	VP
whining questioning offering token weak arguments	VP
visible tremors coursing through the body	NP
a desire to put the person in their place	NP
half-closed eyes a lidded look of satisfaction	NP,NP
averting or lowering one’s gaze	NP,VP
a slight lip press	NP
agreeing even if he’s being irrational	VP
putting the other’s needs and desires first	VP
questioning someone’s source or the facts	VP
chin dipping to the chest adopting a slumped posture	NP,VP
clenching the jaw	VP
movements are functional and precise	NP,VP
breaking eye contact	NP
sensitivity to touch and sound	NP
losing the thread of conversations	VP
body feels cold	NP,VP
a small intake of breath gasp	NP,VP
a desire to belittle the unworthy and exalt one’s own accomplishments	NP
sitting unnaturally still	VP
a crisp nod	NP
rolling the neck back and forth	VP
stalling for time pouring a glass of water and drinking	VP
settling back in a chair in release	VP
struggling to speak to find the right words	VP
an unfocused gaze as one strives for mental calm	NP,VP
taking note of possible exits	VP
pounding a fist against a tabletop	VP
increased swallowing or blinking	UCP
slack muscles	NP
body feels broken	NP,VP
using “word filler” to stall for time	VP
chin tremors	NP
being aware of what lies behind	VP
excessive or manic energy	NP
an increased interest in the other person’s personal life	NP
fiddling with cuffs or jewelry	VP
a desire to die for the emotional pain to end	NP
muscles that are always tense ready to fight or run	NP,ADJP
rejecting help out of a desire to do penance	VP
feigning interest in other things to buy time and regain control	VP
waist	NP
a fast walk jog or run	NP,VP
checking one’s breath	VP
readily agreeing to a punishment or pronouncement	VP
punching kicking throwing things	VP
name-calling	NP
rubbing or pulling at an ear	VP
hands that tremble	SQ
silence	NP
exploring the senses smelling something new for the sake of knowing etc	VP
adhering to superstitious beliefs to stay safe	VP
losing track of time when with the other person	VP
disorientation dizziness or euphoria	NP
leaning forward with a hand on the knee	VP
rooting in a purse or pocket as a distraction	VP
the mind racing through possibilities	NP,VP
broken or unfulfilled promises	NP
reacting with anger or jealousy if one’s reputation is impugned	VP
adrenaline rush	NP
enjoying an event a movie a concert in the park a picnic	SINV
noticing the small things smelling the roses so to speak	VP
a roiling heat in the belly	NP
sitting together so the legs touch	VP
crossing and uncrossing the arms or legs	VP
making an immediate moral judgment either good or bad wrong or right	VP
clasping one’s knees tightly together	VP
a nervous stomach	NP
accepting criticism to improve	VP
a thoughtful expression	NP
limited verbal responses as if the target isn’t even worth talking to	VP
cocking one’s head and then shaking it	VP
stalling gestures taking time to think turning away	VP
worship	NP
contacting the appropriate authorities to express concern	VP
allowing others into one’s personal space	VP
disorientation	NP
yawning	NP
fantasizing violence	NP
a body that feels hot	NP
placing a hand on the chest	VP
pressing a fist to the lips	VP
looming over the target	VP
the mind turning often to the person	NP,VP
enjoyment at proving others wrong	NP
cracking the knuckles or other ‘stalling’ gestures	VP
initiating physical contact with others	VP
head tipping back turning one’s face to the sky	VP
dark circles under the eyes	NP
stumbling mid-stride	NP
having no desire to be anywhere else	VP
openly expressing distrust	VP
a desire to investigate or experiment	NP
offering weak agreement or half-hearted support	VP
pretending to read a book or watch tv	VP
difficulty engaging in conversation	NP
a fist pump	NP
a hitching chest	NP
lightheadedness	NP
a feeling of expansion in the chest	NP
slowly flipping through old pictures stroking the pages	VP
insomnia	NP
a slow pulse	NP
openness when dealing with people	NP
stiff posture square shoulders a lurching walk	NP
muttering uh-huh or yeah when it seems appropriate	VP
pinning the arms against the stomach	VP
telling jokes laughing frequently	VP
flinching recoiling	NP
assuming a pose that’s sexy or draws attention to one’s best attributes	S,VP
looking up with hands raised in the why me position	VP
pressing a fist against the lips	VP
rationalizing or justifying	VP
a quivering chin	NP
wincing or grimacing	VP
unbuttoning the top button of a shirt	VP
raised prominent cheekbones from smiling	VP
leaning in scooting closer	VP
setting goals to obtain the object	VP
throat bobbing	NP
over-thinking problems or choices	NP
a puffed-up feeling	NP
forehead wrinkling	NP
minimizing compliments	VP
feigning interest in something nearby	VP
body mimicking that of the rival	NP,VP
starting to fall then catching oneself	VP
burning in the throat	VP
a smile that wavers	NP
fluttering in the stomach	VP
tipping the head back for a moment and closing the eyes	VP
a nervous laugh	NP
obsession	NP
inability to focus on the needs of others children family	NP
an inability to enjoy positive things or happiness	NP
eyebrows furrowing and then releasing	NP,VP
an upturned face	NP
dropping the chin to the chest	VP
racing thoughts while trying to make sense of the situation	VP
swallowing frequently	VP
drumming feet against the floor	VP
a feeling of possessiveness jealousy	NP
movements that draw attention waving a cigar gesturing with a glass of wine	NP
an unwillingness to leave a certain place phone house car	NP
verbally expressing interest oh look at that or isn’t that amazing	VP
a pattern of subversively trying to undermine the rival in the eyes of others	NP
sore muscles and jaw	NP
hugging oneself	NP
a wide grin	NP
the desire to be alone	NP,VP
pain in the ribs or stomach	NP
a hand pressing against the throat or breastbone	NP
uncontrollable trembling fainting	NP
sweaty palms	NP
lips that flatten or curl	NP
citing unreliable sources	VP
planning and seeking advantages	VP
a bright-eyed look engaging with others or the environment	NP
an inability to formulate an appropriate verbal response	NP
grimacing	NP
rubbing one’s forehead or eyebrows	VP
elevated body temperature	NP
crossing and uncrossing arms or legs	VP
leaning closer	VP
posing hypothetical questions	VP
thickness in the throat	NP
trying to cover body with hands	VP
mouth falling open	NP,VP
eyes that are bright glossy	NP
stilted speaking	NP
involving oneself in the situation internalizing the other person’s pain	VP
arms falling to sides lifeless	NP,ADJP
intent listening so as to catch the suspect in their lie	NP,ADJP
difficulty focusing	NP
cursing swearing	NP
biting at the cheek	VP
reduced blinking	VP
acting like one is simply feeling under the weather	VP,VP
crossing one’s arms while observing	VP
road rage	NP
wonder or interest at how something works or why it’s there	NP
forcing a smile	VP
a long exhale	NP
spewing food or drink if laughter hits while eating or drinking	VP
tight chest	NP
feeling overheated	NP
constantly talking about the subject to others	VP
being snarky or rude seemingly without cause	VP
hiding behind one’s hair	VP
refusing to consider speak of or listen to negatives	VP
a jutting chin	NP
a yelp gasp or squeal	NP,VP
the body freezing in place	NP,VP
a silly grin laughing	NP
apathy	NP
enjoyment of the communal energy	NP
hemming and hawing	NP
poor observation skills	NP
a sense of release when violence is expressed	NP
the mouth opening but no words forming	NP
clawing at the cheeks dragging the fingers down	VP
swallowing a laugh or shout of glee	VP
splaying hands out wide to stretch then relaxing them	VP
hyperventilating shortness of breath	NP
shouting yelling ranting screaming or criticizing	VP
open body posture	NP
speaking often of the person or situation	VP
difficulty breathing	NP
shaking the head emphatically	VP
flapping a hand in dismissal	VP
the feeling that one deserves pain or judgment	NP
a high voice or odd laugh	NP
the world spinning or seeming to slow down	NP,ADJP
difficulty speaking or offering opinions	NP
running through how to do something faster or more efficiently	VP
exploding over little things	VP
sallow skin	NP
raised or wiggling eyebrows	VP
showing off	VP
affectionate touches arm stroking holding hands kissing hugging	NP,VP
avoiding making any decisions at all	VP
tingling nerve endings	VP
speaking boisterously	VP
blowing out a long breath and smiling	VP
excusing oneself for a brief time	VP
engaging in banter or non-threatening conversation	VP
lashing out at others to transfer anger or blame	VP
widening or bulging eyes a double take	VP
saying i told you so	VP
a radiant glow	NP
a hard jaw line a jutting chin	NP
flexing the fingers curling and uncurling	VP
the belief that those who have not succeeded are to blame for their failure	NP
arms clutching one’s body as if to hold it together	NP,VP
crossing one’s arms	VP
unease at one’s options or choices	NP
crashing into things being clumsy but not caring	VP
a gaunt appearance	NP
warm sweaty hands	NP
increased strength or stamina	NP
a downward gaze using the hair as a shield	NP,VP
tears pouring dripping or coursing	NP,VP
switching to another job to keep hands and thoughts busy	VP
showing patience	VP
listening without judgment	VP
hyper-sensitivity to touch and sound	ADJP
looking for ways to discredit the speaker	VP
swinging the arms while walking	VP
agreeing for the sake of it	VP
scanning for potential weapons	VP
deliberately raised eyebrows	NP
joking to lighten the mood	VP
illness	NP
lackluster movements	NP
wanting to be surrounded by family and friends	VP
clamping the lips together	VP
making radical statements or promises about future goals	VP
lungs expanded to their fullest through deep satisfied breaths	NP,VP
using bright or eccentric clothing choices in an attempt to get attention	VP
looking sleepy or glazed	VP
a quick widening of the eyes before schooling one’s expression	NP
using medicine or seeking therapy	VP
sitting still hands clasped mimicking interest and attention	S,VP
hiding one’s mouth behind a hand	VP
angry tears	NP
pinching oneself and using the pain to help contain the emotion	VP
loose muscles	NP
following the one wronged trying to convince oneself to confess	VP
leaning in awkwardly with hands in the pockets asking if things are okay	VP
offering a watery smile while maintaining a safe distance	VP
restless sleep tossing and turning	NP,VP
clouded vision	NP
biting one’s cheek	VP
a rolling stomach	NP
growing animated when memory is triggered an old song playing on the radio etc	VP
buckling knees	NP
lacing fingers behind the head	VP
repeating what someone has said purposely devoid of all emotion	VP
stretching out the legs adopting a wide open stance	VP
difficulty focusing or concentrating	NP
a delayed response	NP
hiding the face	VP
flinching at noises	VP
becoming non-responsive to others almost catatonic	VP
cracking the neck from side to side for intimidation	VP
arguing	NP
losing track of time	VP
holding the arms out wide as if to hug the world	VP
a heavy nod	NP
features are smooth expressionless	NP,VP
pulling in and then slowly releasing a deep breath	VP
muttering what have i done or how could i let this happen	VP
rubbing at one’s exposed forearms	VP
feeling unclean	VP
forcibly declaring that nothing’s going on we’re just friends	NP
beating at walls or surrounding objects	VP
fidgeting instead of sitting or standing still	VP
holing up in a corner placing one’s back against the wall	VP
excessive swallowing	NP
the head pulling back as the shoulders push forward	NP,VP
repeated gestures tie straightening touching an ear	NP,VP
a harsh squint	NP
a need to know touch or understand	DT,VP
switching shifts or altering a schedule to avoid an enemy	VP
comparing oneself to the rival in the eyes of peers	VP
adrenaline rush at taking away another’s power	NP
taking a deep satisfied breath	VP
halting one’s speech to gain control	VP
sensitivity to noise	NP
scattering papers and files in a frantic search	VP
sucking in breath through clenched teeth	VP
wishing someone would stop or shut up	S,VP
over-confidence	NP
wrinkling one’s nose	VP
tightness in the face skin stretched into a snarl	NP,VP
strong posture shoulders back chest out chin high	NP,VP
shoving one’s hands into pockets	VP
believing a lie if it offers hope	VP
downturned facial features	NP
arms swinging while walking	NP
an unfocused gaze	NP
a wide stance fists on hips elbows wide	NP,VP
denial there’s nothing wrong or you’re overreacting	NP,VP
a grimace that lingers	NP,VP
stomach hardening or dropping with a manifestation of dread	VP
a wide stance open demeanor	NP
shoulders that drop or curl	NP
a heightened level of pain resistance	NP
rocking back on heels	VP
agreeability or false enthusiasm	NP
a suggestion that perhaps more thought or study is needed	NP
arms tucking in at the sides	NP,VP
tossing one’s hair back a shake of the head	NP,VP
breaking into sobs	VP
a scratchy throat	NP
tears	NP
reminding oneself of obstacles or competition	VP
long pauses before responding	NP,VP
difficulty responding to questions	NP
an overall relaxation of the body	NP
slouching on a sofa watching old movies	VP
grabbing at the sides of the head in an “i can’t believe it” gesture	VP
talking to strangers to feel connected	VP
making accusations of cheating or underhandedness	VP
rounded shoulders a slumped posture	NP
hair lifting on the back of the neck	NP
watching people furtively	VP
honing in on flaws either of logic or of a physical nature	VP
tangled hair overlong nails and other signs of letting oneself go	NP
knees that bend then straighten	NP
tears welling up behind eyelids	NP,VP
lifting the chin in an attempt to look confident	VP
warmth spreading through the body	NP,VP
eyes narrowing eyebrows pulling down in concentration	NP,VP
using friends to help ostracize or bring the enemy low	VP
an unsteady walk	NP
taking over a project or duty	VP
new wrinkles	NP
a wave of heat or cold	NP
constant planning and obsessing	NP
squaring shoulders but without any real force or strength	X
a gaze that flits around the room never settling on a person or object for long	DT,VP
wanting to hide	VP
a vein throbbing visibly in the forehead	NP
a desire to be alone	NP
a desire to be still and let the relief sink in	NP
a tingling in one’s chest	NP
over-thinking organizing every minute detail etc	VP
flinching or cringing	VP
leaning away from the source	VP
a steady calm pulse and heartbeat	NP
curling up on the floor	VP
a slow steady gait	NP
alert to sudden movements	VP
ignoring distractions or discomforts	VP
a determination to make the best of the situation glass half-full	NP
shaking out the hands in an effort to relax the body once the initial shock has passed	VP
dropping the shoulders then hitching them up again	VP
doodling on paper	VP
a shrill voice	NP
a disconnect between the mind and body	DT,VP
checking and rechecking a phone for messages	VP
slowing one’s speech concentrating on being articulate	VP
loose limbs	NP
the sense that time has stopped	NP
becoming self-critical questioning clothing choices abilities	VP
restlessness pacing tapping fingers clock-watching	NP,VP
feigning a headache or other malady rather than admit one’s limits	VP
hiding expressive gestures like hand wringing	VP
propping a cheek on a fist	VP
verbally attacking any perceived opponents	VP
door watching	NP
lip biting	NP
a clenching stomach	NP
an inability to join in fun activities or be with friends	NP
a collapse in body posture	NP
guarding one’s personal space	VP
wrinkling the nose like there’s a bad smell	VP
arriving early	VP
getting tongue-tangled	VP
tapping a foot fidgeting	VP
averting one’s gaze	NP,VP
enjoying communal happiness feeling part of the crowd	VP
fluttery hand movements	NP
increased difficulty in finding the right words	NP
narrowed eyes	NP
becoming non-responsive	VP
thoughts scrambling to understand	NP
sidestepping but keeping one’s gaze on the source	S,VP
visible swallowing	NP
eyes widening a bit before control is asserted	NP,VP
not knowing where to look or go	VP
over-indulgence in a habit nail biting lip biting scratching the skin raw	NP,VP
joyful tears	NP
telling and retelling stories about the past	VP
avoiding eye contact with others	VP
jumping at sounds	VP
increased sickness due to compromised immune system	NP,ADJP
hugging grabbing onto someone’s arm and holding it	VP
stroking or rubbing an eyebrow	VP
gossiping with others sharing excitement giggling	VP
a thrust-out chest	NP
weakening muscles trembling in the limbs	VP
dry washing one’s hands	VP
rising body temperature	NP
a pulling sensation in the gut	NP
not bothering to answer someone’s questions	RB,VP
lethargic hand movements	NP
forced nonchalance to avoid the subject’s notice hands in pockets	NP
second guessing fearing others will think one’s concerns are irrational	ADVP,S,VP
a direct manner eye contact strength in voice	NP,VP
comforting others	NP
smiling or winking at the person but not offering verbal support	VP
rapid speaking	NP
headache or jaw pain	NP
weak knees or legs	NP
forcing oneself to maintain eye contact	VP
resentment	NP
a tightening under the eyes	NP
nervous laughter or giggling	NP
weakness in the knees	NP
attempting to keep a neutral facial expression	VP
biting or chewing at the lip	VP
trembling hands	VP
asking a question that has a painfully obvious answer	VP
looking ahead to possible collateral damage	VP
being honest about one’s role in the situation	VP
clutching the stomach	VP
waving someone off	VP
looking pale having a harried or haunted look	VP
openly staring	ADJP
mouth drying	NP
touching the throat	VP
pallid skin from lack of sunlight	NP
crouching or leaning forward to get closer without being seen	VP
frustration or impatience	NP
taking a deep breath before acting	VP
taking a deep breath and holding it in	VP
lips pulling back baring the teeth	NP,VP
a raised voice	NP
hands that briefly clench	NP
bottling up one’s breaths to try and calm down	VP
exhaustion	NP
compounding mistakes	NP
a slight head shake	NP
adopting a challenging tone arguing	VP
pursing or pressing lips flat	VP
feet and torso facing the advantage	NP
coughing	VP
watching others and mimicking them as a way of appearing normal	VP
no longer finding joy in hobbies or favorite pastimes	VP
hesitant steps	NP
an overall brightening when the other person enters the room	NP
standing or sitting stiffly	VP
drawing on moral beliefs to help one decide	VP
knees locked tight together	NP,VP
living off the grid	VP
wearing plain clothing to reinforce invisibility	VP
seeking reconciliation determination to set right	VP
tapping a fist against the lips	VP
scuffing a chair closer to the table	VP
rolling up sleeves or loosening a collar	VP
eyes that water	VP
crossing and uncrossing one’s legs	VP
emptiness numbness	NP
resistance to pain from rushing adrenaline	NP
wearing too much makeup	VP
a weakened voice	NP
covering one’s face with one’s hands	NP,VP
biting the lip or inside of the cheek	VP
bringing one’s legs up close to the body’s core	VP
staying at the edge of a group seeking the corner of a busy room	VP
self-destructive behaviors	NP
flinching or starting the body jumping slightly	VP
shivering moaning	VP
heat and tingling in face	NP
putting on a happy face	VP
facial tics or repetitive mannerisms hair tugging body rocking	NP,VP
appreciating the world and everything in it	VP
an unnatural stillness	NP
hesitation accepting a leaflet with reluctance etc	NP,VP
eyes prickling with tears	NP,VP
bloodshot eyes	NP
cringing away from the source	VP
shielding having a death grip on a purse	VP
whimpering	NP
muscle tightness	NP
a sidelong glance	NP
buzzing the lips to be rude blowing a raspberry	VP
digging in a purse or pocket to keep the hands busy	VP
spots of color entering the cheeks	NP,VP
fear of public speaking or being on display	NP
a desire for perfection	NP
shutting a door with more force than necessary	VP
denying fear through diversion or topic change	VP
nerve endings that stir and tingle	NP
arms hanging at one’s sides	NP,VP
a sharp tone	NP
thickness in throat	NP
shaking with excitement	VP
raised blood pressure	NP
dismissing the situation without making a decision	VP
closed eyes compulsive nodding	NP
clutching one’s hands	VP
impetuosity	NP
twitching lips	NP
being unable to focus on tasks work school home life	VP
blowing a kiss	VP
a downturned mouth or pinched lips	NP
an overall weighted feeling	NP
intense thirst	NP
spontaneous laughter	NP
self-doubt a lack of confidence	VP
always seeing the worst-case scenario	ADVP,VP
a deliberate eyebrow raise and head tilt	NP
staring down at one’s empty hands	VP
crossing the legs	VP
steering or dominating the conversation	VP
an inability to focus on anything but the decision to be made	NP
preachy advice do what i did and you’ll succeed too	NP,VP
hurrying or rushing to make things happen quicker	VP
restless fingers	NP
gently biting the lip	VP
an exaggerated eye roll or upward glance	NP
panic attacks phobias	NP,VP
phoning or texting to share news or pass on the excitement	VP
tears or shakiness	NP
drinking too much coffee smoking too much	VP
having no interest in hobbies	VP
a lingering touch brushing up against the object	NP,VP
pacing	NP
uncontrolled tears	NP
tightness or pain in the chest	NP
using um and uh hesitations	VP
leaning against one another	VP
sweeping a hand across the forehead to get rid of sweat	VP
relief	NP
a heartbeat that races when one feels confronted	NP
standing close yet not touching	NP,ADVP,RB,VP
stalking off to get some air	VP
choosing isolation	VP
feeling overwhelmed in a good way	VP
crossing the arms over the chest	VP
lying or misleading others	VP
gaping stuttering mouth opening and closing	NP
revealing true feelings to a third party hoping they’ll pass the information along	NP,VP
swallowing more than usual	VP
hair lifting on the nape and arms	NP
speechlessness or incoherence	NP
eyes widening	NP
taking up space legs spread wide arms loose at the sides	S,VP
shutting down mentally retreating inward	VP
asking redundant questions to assure that the moment is real	VP
risking lesser danger in order to escape	VP
not leaving or walking away despite discomfort	VP
an easy walk unhurried	NP,VP
destroying property	VP
adjusting clothes as if they chafe	VP
looking all around especially behind	VP
growing reclusive cutting oneself off from others	VP
time feeling like it’s slowing down	NP,VP
repetitive sharp gestures shaking a fist etc	NP
making a hmmm noise in the throat	VP
tipping one’s head side to side weighing an idea or choice	VP
extreme mental focus on the objective	NP
refusing to look	VP
biting the lips to keep from smiling	VP
questioning others as a way of gathering information	VP
staring down at the ground	VP
inflicting pain on oneself as a penance	NP
adhering to a routine eating the same meals visiting the same park	VP
hands folded in one’s lap	NP,VP
actively seeking to bring people over to one’s way of thinking	VP
pretending to have misheard	VP
swallowing and nodding	VP
unhurried speech	NP
asking questions how long when what is it	VP
sending someone a long pained look and then breaking eye contact	VP
losing one’s voice from screaming or shouting	VP
demanding a rematch	VP
aligning with fringe groups and conspiracy theorists	VP
a quiver in the stomach	NP
scraping a hand over the face as if to wash away emotion	VP
shaky laughter	NP
preparing for the best case scenario	VP
a need to touch and explore	DT,VP
becoming less verbal over time	VP
dismissing negative thoughts	VP
shouting insults name-calling	VP
heat flushing through the body	VP
whining grumbling or pouting small children	VP
offering a fake smile	VP
a need to ask questions and rehash information	DT,VP
talking to friends about the special person asking for advice	VP
using sarcasm	VP
shifting attention to others putting them in the spotlight	VP
increasing one’s personal distance from others	VP
letting out an uncontrolled moan	VP
closing the eyes and taking a calming breath	VP
agreeing too quickly too loudly	VP
shouting cursing	VP
flight reaction running away hiding	NP
giving a toast or praise	VP
changing the topic to bring others into the spotlight	VP
slamming doors cupboards or drawers	VP
shaking one’s head in denial	NP,VP
tenseness in one’s stomach	VP
dredging up evidence in order to sway opinions	VP
an arrogant laugh	NP
body tensing	NP
laughing	VP
not reacting to stimuli laughter excitement activities	RB,VP
a pinched expression	NP
narrowing eyes	NP
leaning in aggressively as if to challenge	VP
checking and rechecking email	VP
shattered thoughts	NP
speaking in a quiet voice	VP
thoughts spinning focusing inward	NP,VP
disconnecting from others	VP
replaying what happened	VP
a light bouncing step	NP
hand splaying across one’s upper chest	VP
using affirmative words yes and i will	S,INTJ,NP,VP
wet or red eyes	NP
shuffling feet	NP
head down as the eyes look up	VP
a split second where breathing is suspended	NP
poor sleep	NP
pushing up one’s sleeves	VP
slightly clenched fists	NP
benign questions	NP
looking down one’s nose at others	VP
avoiding topics of conversation that will kill the mood	VP
a smirk or sneer	NP
avoiding friends who are also culpable if a group act	VP
shaking one’s head muttering	VP
passive-aggressiveness	NP
looking others directly in the eye	VP
a coveting gaze that drifts to the symbol of envy the advantage	NP,VP
fluttering or even mild pain in the chest	VP
turning the body at an angle instead of facing the subject head-on	VP
straying attention	VP
a need to verbalize the internal conflict	DT,VP
replaying the events that caused the feeling	VP
thoughts searching for a solution	VP
rubbing the back of one’s neck	VP
increased confidence	NP
a desire to flee or be alone	NP
clutching the throat or chest	VP
stalled breaths	NP
slanting the body away from an accuser	VP
a cracking voice	NP
dialogue in the negative don’t blame me or i had nothing to do with it	S,CC,S
picking at food too excited to eat	VP
asking for reassurance	VP
a nonchalant attitude	NP
hands clasped loosely behind the back and gaze down	NP,VP,CC,VP
mean-spirited talk behind another’s back	NP
adopting new hobbies to distract oneself	VP
an animalistic growl in the throat	NP
offering the bright side at least now we know or it could have been worse	VP
a longing gaze	NP,VP
desiring to confess or share the pain or burden with another	VP
sniffing wiping at nose	VP
losing awareness of surroundings when love interest is present	VP
restless fiddling	NP
breathing slows as a memory takes over	NP,VP
biting the nails chewing on a knuckle	VP
eyes squinting tightening	NP,VP
handling objects or people roughly	VP
putting away happy thoughts to savor later	VP
seeing similarities in the present you look just like him or this is the same color as our	VP
a snort of dismissive laughter	NP
jerking the head back	VP
arms crossed	NP,VP
firm eye contact	NP
snapping a pencil tip using unnecessary force	VP
tapping a loose fist against the heart	VP
clutching a purse coat or other object	VP
passive skepticism becoming more overt	NP,VP
sneering	NP
retreating into the fetal position or curling up on the knees	VP
creating chance run ins	VP
handling distractions answering the phone so the other person won’t have to	NP,VP
turning away to gather one’s thoughts	VP
shoving pushing tripping	VP
nostrils flaring	NP
wiggling squirming	VP
muscles jumping under the skin	NP
distractedness	NP
shaking uncontrollably	VP
a reddening of the face	NP
hoarding	NP
trying to put the upsetting information out of one’s mind	VP
a longing so intense it manifests itself as an ache or pain	NP,ADJP,S
shutting down not speaking or responding	VP
becoming unnaturally quiet or still	VP
closed body posture crossing the arms	VP
abusive relationships	NP
rubbing at the back of one’s neck	VP
a thinning mouth	NP
verbalizing shock are you kidding or impossible	S,VP
a satisfied smile	NP
feeling vindicated for the effort sacrifice or hard work	VP
expressing skepticism	VP
bingeing to compensate eating drinking shopping gambling	VP
hiding behind a book	VP
feeling powerless over the present or future	VP
a sad smile	NP
weighing the danger level of the situation	VP
a bitter smile	NP
dizziness seeing black spots	VP
apologizing	NP
hands gripping each other or an object	NP,VP
being unnaturally quiet	VP
confusion how did this happen or what will happen to me now	NP
hands jammed into armpits or self-hugging	NP,VP
rambling when conversing with others	VP
repetitive swallowing	NP
clamping the teeth shut to contain hard words	S,VP
rage	NP
feeling trapped	VP
unconsciously parting the lips	NP,VP
irrational thoughts taking risks to get even	NP,VP
an inability to fill lungs completely	NP
leaning back an arm hooked over the back of a chair	VP
wanting to face the consequences	VP
wallowing drinking too much listening to depressing songs	VP
flawed reasoning	NP
glancing away for a brief time	VP
an emotion-choked voice	NP
hiding a smile behind a hand	VP
offering to take him somewhere—a walk a car ride to hang out	VP
suicidal thoughts	NP
biting at the lips or nails	VP
breaking down tears	VP
breaths that hitch	VP
appearing unbothered by what others may think	VP
dropping out of activities and moving away from friendships	VP
pulling the knees up to the chest circling one’s knees with the arms	VP
a bubbly or light voice	NP
hypertension	NP
a wandering gaze taking in random things	NP,VP
fumbling	NP
raising one’s voice	VP
holding oneself tightly clutching the arms or wrapping arms around the belly	VP
premature gray	NP
heart problems	NP
demanding that someone stop speaking or desist what they are doing	VP
lips pressing together in a slight grimace	NP,VP
negative thoughts	NP
asking simple questions for clarification who when why	FRAG
flopping back in a chair	VP
holding still in expectation	VP
heaviness in the limbs or muscles	NP
excessive saliva a need to spit	NP,DT,VP
bragging	NP
patting a leg in comfort	VP
feeling too hot or too cold	VP
complaining under the breath where is he or this is taking too long	VP
leaning forward elbows on knees	VP
a pouty bottom lip	NP
feeling flustered by a less-than-ideal situation	VP
asking for assurances or clarification	VP
quickened pulse	NP
crossed arms	NP
crossing the arms or legs	VP
smiling at other objects	VP
pushing past one’s limits to find needed strength	VP
dizziness weakness in the legs and knees	NP
shoulders back	NP
offering the advice of a relative or well-known person as my uncle used to say…	VP
legs that are planted wide	NP
a willingness to do anything	NP
eyebrows squeezing together	NP
uttering dark hurtful words meant to provoke	VP
a smirk	NP
a stomach that feels hard	NP
a desire for revenge	NP
looking around in confusion or shock	VP
doodling hearts and names	VP
mocking	NP
stroking one’s own neck or arm as a surrogate	VP
showing one’s palms and shrugging	VP
swaying from side to side	VP
worrying over the current path	VP
sacrificing what is needed to achieve the desired result	VP
a lack of energy	NP
tilting one’s head to the side and pursing the lips	VP
watching others to see their reactions	VP
attempting suicide as a way out	VP
telling jokes adding to or steering a conversation	VP
unbuttoning a top shirt button	VP
whooping loudly	VP
stopping to listen intently	VP
thoughts scatter too excited to think straight	NP,VP
quickened breaths	NP
uninterested in hobbies or entertainments	NP
saggy posture bent neck	NP
fixating on the talents and strengths of others	VP
weight loss	NP
diversion rather than open support	NP
fluid movements	NP
forming a steeple with hands and pressing them to lips	VP
focusing thoughts to keep fear from taking over	VP
writing secret letters keeping a diary	VP
believing that one is ugly or unworthy	VP
obsessing over why things happened the way they did	VP
increased tenderness sitting close a quick kiss for those who shared in the event	NP
being confrontational what are you doing here or what do you want	VP
squeezing a shoulder or hand	VP
grabbing one’s hair in clumps looking up at the sky	VP
indecisiveness	NP
pain that is suspended until later	NP
smirking or offering a bemused smile	VP
pressing the palms to the eyes	VP
using the hair to hide the face	VP
becoming suddenly still	VP
holding an object as a shield a book a folded jacket	VP
crumpling to the floor	VP
storming out of a room	VP
nervous habits running hands through the hair pacing repetitive gestures	NP,VP
desperately seeking out new relationships	VP
laying one’s head down on the table	NP,VP
an unexpected release of all tension	NP
sniping remarks	NP
coughing pretending a drink went down wrong	VP,VP
becoming argumentative	VP
heart attack	NP
hair loss	NP
asking those in authority for updates	VP
a chest that hitches	NP
shaking trembling	VP
a heavy-footed walk	NP
running away	VP
first car	NP
smoothing one’s clothes or touching items to keep the hands busy	VP
using more force than necessary stomping feet throwing instead of handing off	VP
lightly touching a shoulder	VP
reluctantly speaking or approaching someone	VP
chin lowering and pulling back against the neck	NP,VP
striving to also excel at whatever is desired	VP
rubbing the chest as if pained	VP
cutting people off	VP
trying to see and hear everything at once	VP
chest pain or numbness	NP
defensiveness	NP
a slack or soft expression	NP
nails biting into one’s own palms	NP,VP
holding one’s head in hands	NP,VP
wanting to care for and put the object’s needs first	VP
briefly closing the eyes	ADVP,VP
relief for owning up to wrongdoing	NP
gathering other like-minded people and encouraging their scorn	VP
breaths that catch or hitch	NP
tilting one’s body toward the source	VP
visible blushing	NP
ignoring or neglecting other friends to be with the significant other	VP
quick movements no hesitation	NP
visible tension in the muscles	NP
euphoria pleasure at touching and closeness	NP
running makeup	NP
leading rather than following	ADJP
pinching the bridge of the nose eyes closed	S,VP
chin poking forward	NP,VP
pulling arms and legs in toward the core	VP
pulling or plucking at clothing as if that is the source of discomfort	VP
a single shoulder shrug that breaks quickly	NP
checking and rechecking the time	VP
consciously forcing one’s limbs to relax	VP
self-hugging to contain the feeling	VP
bringing a box of tissue or a cup of tea unasked	VP
digging for tissues	NP
hesitation	NP
speaking only when spoken to	VP
a flush of adrenaline tingling through the body	NP
rubbing the nose or ears	VP
a fast pulse	NP
barking orders yelling	VP
suicide attempts	NP
false confidence	NP
sleep loss	NP
lifting a hand loosely palm up in a “who cares ” gesture	S,VP
sobbing or weeping	VP
hosting events getting the guys together for a football game	VP
obsessing over finding a way to repay the debt	VP
twisting one’s neck as if sore	NP,VP
leaning or turning away from the person making the request	VP
obsessive thoughts	NP
hands that shake nervous twitching	NP
a shaking or raised voice yelling	NP
shifting in one’s chair	VP
breath that temporarily bottles up in the chest	NP
lightly stroking a forearm	VP
not speaking or making any sound	RB,VP
shifting unable to get comfortable	VP
vomiting	NP
squeezing one’s eyes shut	VP
happiness over a job well done	VP
a harried appearance	NP
suicide	NP
heightened watchfulness	NP
exchanging knowing looks with others	VP
putting oneself down	VP
a feeling of entitlement i deserve it or that should be mine	NP
lowering the voice to a whisper	VP
aggressive teasing intended to put another in their place	NP
tense muscles rigid posture	NP
eyes that are cold hard flinty	NP
pulling books or packages tightly against one’s chest	VP
looking down while walking	VP
deep breaths	NP
sensitive skin	NP
verbal denial i’m fine really	NP,VP
hypochondria	NP
broken dialogue self-interruptions	NP
stretching	NP
avoiding the suspected person	VP
destroying one’s own possessions	VP
grabbing another person and saying tell me	VP
a closed-lipped smile	NP
hmms as opposed to overt agreement	NP
nodding eyes glowing	VP
a desire to tell everyone about the success	NP
touching a cross or fingering jewelry for comfort	VP
walking quickly to erase the distance	VP
taking a deep pained breath and closing the eyes	VP
hands hidden behind the back or in pockets	NP,VP
stiff posture	NP
a sour taste in one’s mouth	NP
clapping	NP
rapid swallowing and nodding	NP
a desperate need to find answers	NP
hands almost curling into fists and then straightening	NP
jerky movements a loss of fluidity to actions	NP,VP
lifting the heels and rising up slightly to emphasize words	VP
engaging in meaningful conversations	VP
spots or flashes in vision	NP
biting down on one’s bottom lip	VP
scraping a hand through the hair	VP
holding a hand up warding someone or something off	VP
pleading crying begging to be believed	VP
dependency on caffeinated beverages or drugs to stay alert	NP
obsession with an object that represents loss a photo or trinket	NP
mooning over photos or representations of a love interest	VP
bouncing lightly in place	VP
staring but not seeing eyes shut or crying	VP
eyes that dance sparkle or shine	NP
staring down at one’s hands	VP
covering oneself crossing the arms closing a jacket	VP
anger	NP
thoughts filled with self-loathing	NP,VP
moving closer	VP
verbally denying having anything to do with the event	VP
talking too fast	VP
standing tall with good posture legs spread wide	NP,ADJP
clinging to loved ones	VP
an unhurried walk	NP
friendliness even with those not in one’s own social circle	NP,ADJP
careful words	NP
damaging one’s own property as a way to vent	NP,VP
loss of appetite	NP
impatience with corporate greed and capitalism	NP
closing one’s eyes as if relaxed or dosing	VP
whimpers of mirth	NP
muddied or panicked thoughts	VP
a need to run jump scream whoop it up	DT,VP
body tremors	NP
a shaking voice	NP
nodding to others in greeting	VP
focusing on improvement studying working extra hard	VP
smiling at nothing	VP
rudeness	NP
nitpicking	NP
head tipping back on the neck to look skyward	VP
controlling one’s movement with intent	VP
doing or saying things outside of the norm without anxiety or concern	VP
the chest caving	NP
searching for ideas on how to circumvent the situation	VP
a lump forming in one’s throat	NP
turning away from others	VP
anxious movements pawing a hand through the hair pacing	NP
taking a deep breath	VP
criticism and belittlement	NP
humiliation fantasies featuring the enemy	NP
walking out of the room	VP
discontentment with the way things presently are	VP
difficulty forming responses	NP
rubbing at or massaging one’s chest as if pained	VP
a too-frequent smile	NP
rubbing at the middle of one’s forehead eyes closed	VP
holding a plate of food but not eating it	VP
a determined walk strut or swagger	NP
yelling or shouting	VP
running a jerky hand through the hair	VP
squeezing the hands at one’s sides	VP
difficulty speaking choppy responses	NP
glancing repeatedly at the clock	VP
moving closer to erase distance	VP
responding with anger shoving punching	VP
a complete break with reality	NP
movements that lack energy	NP
a stiff neck strained muscles	NP,VP
leaving to show that the target is not worth one’s time or energy	VP
slanting the body away from the source of anger	VP
a heavy feeling in the stomach	NP
sagging into a chair leaning against a door frame or wall	VP
inappropriate responses laughing screaming	NP
comparing oneself to others and finding oneself lacking	VP
a strained voice	NP
wandering a short distance away before returning	VP
insomnia and fatigue	NP
big movements leaping fist pumping running	NP
wanting it to end at all costs	VP
grabbing fistfuls of one’s hair and pulling	VP
an austere lack of mementos from the past	NP
a roiling stomach	NP
stuttering or speechlessness	NP
calmly stating that one doesn’t need to prove anything	VP
making a slight detour as a ruse	VP
darting glances	NP
fantasizing about the day the suspect is finally exposed	ADJP,NP,VP
being at ease with the world content	VP
biting or chewing on one’s lip	VP
increased heartbeat	NP
preoccupation with the object’s scent	NP
light-headedness	NP
glancing at the clock phone or doorway	VP
shame is by and large private people are always trying to suppress this emotion so all	S,CC,S
bouncing on the toes	VP
an inability to sleep or eat	NP
torso and feet pointing toward the loved one	NP,VP
a sensitive stomach	NP
false smiles and confidence	NP
a grin that conveys secret knowledge	NP
wringing one’s hands	VP
closing the eyes and sighing	VP
clapping the hands over the ears	VP
tendons standing out in the neck a visible pulse	NP,VP
eyes narrowed as if in confusion	NP,VP
dry throat	NP
an incredulous stare or dazed look	NP
wanting to shield oneself and others from the person	VP
facial tics muscles that jump	NP
precise movements	NP
rubbing one’s forearms	VP
turning away and covering the mouth	VP
repeating one’s thanks and appreciation	VP
hands that fidget twisting together rubbing down the front of one’s pants	NP
closed body posture arms creating a barrier across the chest	NP
pacing in short spans	NP
a grimace or pained look	NP
face tightening	NP
a feeling of weightlessness	NP
running through what one must say or do	VP
watching the source furtively	VP
rubbing a hand against the heart	VP
a blank look	NP
phoning or texting friends to talk about what’s coming	VP
a stomach that feels rock hard	NP
dismissing the source as unworthy	VP
a need to be alone	DT,VP
a high chin and exposed neck	NP
picking at lips skin or nails	VP
guilt toward those negatively affected by a final decision	NP
cockiness	NP
grabbing onto another person refusing to let go or leave them	VP
squinting and a hard smile	NP
a sour or bitter tang in the mouth	NP
folding the arms across the chest	ADJP,NP
biting or picking at one’s fingernails	VP
a floating sensation like all one’s burdens have been removed	NP,VP
bending forward laying head on arms	VP
setting goals	VP
realigning hobbies or interests to match the other’s	VP
frantic planning for the event	NP
holding elbows wide from the body chest thrust out	NP,VP
smiling	VP
walking off refusing to stay in another’s presence	VP
phobias	NP
disregarding another’s feelings if they conflict with one’s goal	VP
clenched jaw grinding teeth	NP,VP
rising body heat	NP
a warm voice caring tone	NP
hands clasped in prayer pressed to the lips eyes closed	NP,VP
unnatural stiffness	NP
feet shuffling kicking at the ground	NP
a release of all bodily tension	NP
swiping at tears trying to hide them	VP
deflecting attention and assigning blame to another	VP
premature aging	NP
constricting the throat	VP
rapid blinking followed by open staring	NP,ADVP,VP
uncertainty that bleeds into other decisions and situations	NP
hands clutched together	NP,VP
manic pacing	NP
an emotion-rich voice	NP
backtracking to try and undo something said in haste	VP
tightening the hands into fists then loosening them	VP
stroking or smoothing someone’s hair	VP
rigid posture	NP
quick darting glances to express a hidden thanks	NP,VP
letting out a loud breath	VP
trying to reason or explain	VP
rigid and defined forearm muscles	NP
withdrawing from society	VP
protruding eyes	NP
becoming extra animated when there’s an audience	VP,VP
pleading or begging	VP
becoming non-responsive less verbal	VP
an inability to cope with smaller problems over time	NP
a heavy sigh	NP
rushed breathing	NP
standing back from the suspect not stepping into his circle of friends	VP
clumsiness due to rushing slopping coffee knocking something over	NP,ADJP
glaring	NP
single-minded focus on how to destroy another	NP
satisfaction at having experienced the event despite any pain or loss resulting from it	NP
extreme risk taking	NP
desiring to share and include others	VP
nervous movements biting nails twisting a shirt button rubbing the neck	NP,VP
irrational responses jumping to illogical conclusions	NP
raising one’s eyebrows	VP
rubbing and twisting one’s hands spinning rings or bracelets	VP
a pinched mouth	NP
arms tight to the body	NP,ADJP
throat growing thick	NP
feeling a pulse in one’s throat	VP
a look that radiates superiority	NP
pulling at the collar	VP
subconsciously thrusting out one’s chest	VP
a shortened attention span	NP
researching searching the web speaking with professionals to find answers	VP
a slight muscle jump in the cheek	NP
a lack of emotion	NP
licking one’s lips smiling	VP
a face that seems to shine	NP
loose posture	NP
stumbling knees hitching	VP
including others in the moment	VP
full body tremors	NP
a quaking voice	NP
scratching	VP
a hyper-awareness of others and their reactions	NP
slow and easy breaths	NP
avoiding speaking or agreeing openly	VP
making demands give it to me	NP,VP
solitary activities that show a craving for contact people watching from the porch	NP
tentatively reaching out or touching	VP
not eating or drinking	NP
grouping with others who also lack whatever is desired	VP
holding the head in the hands	VP
muscles quivering	NP
restricted breathing	NP
giggling making faces winking	VP
a grave expression	NP
tapping one’s index finger against the lip	VP
surrounding oneself with supportive friends	VP
forcing oneself to maintain a slight stiffness in posture	VP
focusing on cleanliness showering rubbing skin raw	VP
rubbing the wrists or wringing the hands	VP
frequently calling family or friends	VP
tingling all over	VP
becoming passive and disengaged	VP
grabbing onto something secure like a steering wheel and shaking it violently	VP
pinching the lips tight to keep them from trembling	VP
heartfelt apologies	NP
cracking knuckles	NP
leaning back or away	VP
pressing a hand against one’s chest fingers splayed out	S,VP
turning away to ignore the source	VP
sliding down in a chair	VP
using excitable language	VP
a sensation of hair raising on one’s arms and nape	NP
settling back in a chair with exaggerated casualness	VP
offering a distraction or changing the subject	VP
a gasp	NP
taking too long to answer a question or respond	VP
wanting to be alone	VP
a flare of adrenaline firing the brain to act	NP,VP
scratching or rubbing the back of the neck	VP
pleading talking to oneself	VP
twisting a watch or ring	VP
a tapping foot	NP
a fluttery empty feeling in the stomach	NP
reassuring others of one’s belief commitment etc	NP
redirecting the focus to allow things to proceed better	VP
wincing a pained expression	VP
holding a hand up warding others off	VP
shoulders back straight posture	VP
shaking shuddering	VP
a single-minded focus to save oneself or someone else	NP
a deliberate crossing of the legs or clasping of the hands	NP
dragging nails down the cheeks	VP
laughter at another’s expense	NP
obedience	NP
tension in the face shoulders and neck	NP
shoulders straight and back	NP
longer recovery time from surgeries accidents and other trauma	NP
rocking back and forth	VP
strong eye contact very little blinking	NP
pretending to ignore or be unaware	VP
lips parting	NP
stomach hardening	NP
screaming for release	VP
stomping up the stairs	VP
cracking one’s knuckles to intimidate	VP
feeling like one’s insides are vibrating	VP
wishing for comfort	VP
attempting to keep one’s voice light	VP
flight response—running away unable to deal with the consequences	NP,VP
pulling on someone’s sleeve to get them to join or follow	VP
increased sensitivity to every sound touch or change in the environment	NP
living in the moment not acknowledging the past or future	VP
excessive sleeping	NP
slowly shaking one’s head	VP
biting the inside of the cheek or bottom lip	VP
muted body language lacking energy	NP
hyperventilating	NP
headache	NP
licking the lip with cautious hope	VP
taking over someone else’s job or duties	VP
faking interest barely holding impatience at bay	VP
uncontrollable flushes of heat	NP
quickening heartbeat	NP
watching at a distance hoping for change	VP
holding one’s breath gulping down breaths to stay quiet	VP
pinching the skin at the throat	VP
racing heartbeat	NP
self-mutilation	NP
forcing the target into circumstances where he is sure to fail	VP
rubbing at the forehead or temples	VP
high energy a bouncing walk or run skipping	NP
a desire to talk the situation over with someone else	NP
clamping one’s lips tight to keep from saying anything	VP
smiling a playful grin	VP
nodding rather than speaking	VP
recording the suspect’s activity and movement notes pictures etc	S,VP
heaviness or tightness in the chest and limbs	NP
shaking extremities	NP
hesitating	VP
eating disorders	NP
gratitude to those who helped make this possible	NP
hands repeatedly rising to touch one’s face	NP,VP
hyper-vigilance	NP
noncommittal answers	NP
rubbing it in with an i-told-you-so	VP
a monotone voice	NP
knees going weak	NP
listening arms crossed over one’s chest	VP
checking and rechecking hair or makeup in a mirror	VP
scrambling thoughts trying to diffuse the situation	VP
a fixed stare	NP
feet that bounce or tap	NP
asking others for advice or opinions	VP
staring down at one’s hands or feet	VP
taking a step back	VP
berating oneself for actions or choices	VP
leaning in	VP
brooding retreating inward withdrawing from others	VP
slightly parting the legs	NP,NP
a tentative smile that builds as surprise sinks in	NP,VP
a compulsion to flee fight-or-flight	NP
glancing at one’s watch	VP
cold fingers	NP
a silent look	NP
pinching the bridge of the nose and tightly squeezing the eyes	VP
embellishing the event in one’s mind increasing the mirth	VP
being unable to think or talk about anything else	VP
declining an offer of support	VP
dancing	NP
a tilted-back head	NP
tightening fists	NP
turning away	VP
fidgeting squirming	VP
an aching chest	NP
swallowing	VP
citing a backup plan or listing more options	VP
an intense fevered stare	NP
a gaunt appearance wasting away	NP,VP
avoidance of the source	NP
a hard distinctive jaw line	NP
lavishing praise on favored ones children friends people in power	SINV
wishing comfort from others	VP
fingers forming a steeple	NP,VP
throat closing up	NP
flu-like symptoms nausea sweats tingling in chest	NP
ugly laughter	NP
clenched grinding teeth	NP
giving a half-shrug or a grin that conveys secret knowledge	VP
perfect posture shoulders back exposed neck	NP,VP
a pale or unhealthy complexion	NP
a downcast expression	NP
hands touching the lips mouth face	NP
a lack of empathy	NP
becoming submissive giving up control	VP
deflecting acting as if the request is absurd	VP
a sinking feeling in the stomach	NP
avoiding eye contact	VP
wheezy breath	NP
a willingness to endure suffering or hardship to obtain the object	NP
moving slowly and deliberately toward another person to intimidate	VP
a fading sense of empathy	NP
falling against someone shoulder to shoulder	VP
punching fists against thighs to release frustration	VP
initiating random acts of kindness	VP
an acute sense of purpose	NP
a sense of calm and ease	NP
breath that catches or stops briefly	NP
premature aging wrinkles tired eyes gray or white hair	NP
limbs that feel too heavy to lift or move	NP
pinching the lips together	VP
pressing the lips together	VP
uncontrollable whimpering	NP
grabbing or stealing the coveted object	VP
apologizing not out of accountability but to voice the unfairness of the situation	VP
lying	NP
muscle clenching along the jaw line	NP
not thinking or caring about consequences	RB,VP
planning or obsessing over every detail	VP
biting the lip or nails	VP
jamming or cramming things away without care	NP
the feeling of being watched	NP
using articulate words and short strong sentences	VP
becoming easily offended	VP
attempting to loosen up by rolling the shoulders	VP
a posture that suggests discomfort standing by oneself clamping the hands around the	NP
wanting to share the experience with others	VP
indulging in petty crime keying the rival’s car etc	VP
cold sweat	NP
voicing conflict this is a tough decision	S,NP,VP
using pet names or terms of endearment	VP
rubbing the hands over one’s clothing	VP
attempting to distract him going to the movies a party drinking	VP
despair hopelessness	NP
the chin dipping down	NP,VP
asking questions to further incriminate the target	VP
leaning back at ease and in control	VP
feigning boredom	NP
offering praise for others	VP
doting on someone or something a neighbor a pet	VP
rash decisions impaired judgment	NP,VP
shifting about	VP
gaze clouding going distant	VP
forcing enthusiasm because it’s “the right thing to do”	VP
chin lowering to one’s chest	NP,VP
not engaging in conversations about the past	RB,VP
ache in the throat	NP
alert to others to see how they react and what they do	VP
speaking in a soothing placating voice	VP
refusing to argue or respond to an accusation	VP
placing one’s hands in one’s pockets	VP
requesting some time to digest everything	VP
pretending to be ill to avoid social situations and people	VP
hands carving through one’s hair holding it back and then releasing	NP
tense muscles	NP
increasing one’s distance from others	NP,VP
privately praying for the person	ADVP,VP
believing in anything that promises a positive outcome	VP
attention straying to other things	NP,VP
hugging friends close by	NP,VP
repeating a mannerism scratching an eyebrow adjusting glasses	VP
pulling or tugging on an ear	VP
relaxed muscles	NP
hands fluttering like they’ve lost track of what they should be doing	NP,VP
sarcasm whatever or sure you are or if you say so	FRAG
heart disease	NP
hypersensitivity to the source of interest	NP
an overall visage that glows or radiates	NP
asking someone to repeat what was said	VP
holding a hand up as if to say no more	VP
theatrical groaning	NP
wearing false overly bright smiles	S,VP
feeling fake from wearing two faces for so long	VP
muttering negatives i don’t think so or no way that would work	VP
following the aggrieved party	VP
clutching at one’s arms or stomach	VP
focusing inward	VP
stroking or pinching one’s throat	VP
withdrawal	NP
nose-wrinkling	NP
dizziness	NP
holding one’s stomach	VP
blowing cheeks out then swallowing the air or releasing it	VP
making excuses to avoid the situation	VP
focusing on the other’s best attributes	VP
tight muscles	NP
touching or stroking one’s own throat	VP
tingling in the stomach	VP
clasping one’s hands to the chest	VP
self-loathing	NP
pushing on the diaphragm to keep the anger in	VP
jerky movements talking with the hands changing direction mid-stride	NP,VP
laying a hand against the breastbone	VP
breathing is slow and even	NP,VP
wrinkled disheveled clothes	NP
slow cautious movements	NP
agreeing to attend happy social events then not showing	VP
raising up or bouncing on tiptoe	VP
holding one’s elbows tightly against sides	VP
shoulders drawing up elbows tucking into the sides	NP,VP
backing away	VP
talking about one’s accomplishments as a way of winning people over	VP
clutching at one’s chest on reflex	VP
pressing palms lightly against the cheeks	VP
asking for affirmation are you sure	SINV
sneaking looks at the subject	NP,VP
attempting to escape via distraction tv book music	VP
bouncing on one’s toes	VP
a puffed-out chest	NP
researching or seeking information	VP
fuzzy thoughts an inability to think	NP
changing the topic to something safe	VP
rapid swallowing	NP
obsessive information-gathering looking for the “key” solution	NP,VP
tugging one’s hair	VP
watering eyes	NP
getting away at the first opportunity to tell someone the good news	VP
reaching out to another for comfort	VP
supplying reasons to convey that a viewpoint is invalid	VP
a desire to bring others in and create a mob mentality of resentment	NP
trying to maintain eye contact	VP
a fluttery feeling in the belly	NP
hugging holding pulling someone against your shoulder	NP
staring down at the floor	VP
offering commitment to show one’s ability to meet expectations	VP
rewarding oneself	VP
giddiness	NP
toying with items turning a cup mangling a paperclip	VP
carefully preparing an argument or plan of attack	VP
touching a temple while closing the eyes	VP
a willingness to put oneself in harm’s way for emotional relief	NP
a grip that unintentionally crushes or breaks snapping a pen etc	NP
bolting out of hiding rushing away from the threat	VP
dullness in the chest a feeling of heaviness	NP,NP
a sour taste in the mouth	NP
rubbing sweaty hands on one’s clothes	VP
an expressionless unsmiling face	NP
active listening	NP
circling approaching someone or something in a roundabout fashion	VP
focusing on alleviating another’s pain rather than one’s own	VP
feeling exhausted or strained to the limits	VP
pressing fists to the sides of the head	VP
alcohol drug or medication dependency	NP
jumpiness	NP
false smile	NP
reaching out to touch and then pulling back as if not worthy	VP
citing an opponent’s shortcomings	VP
flaring nostrils	NP
tears that one does not try to hide or control	NP
rolling the neck	VP
thinking of an excuse to leave	VP
speaking rapidly not letting others get a word in	VP
daydreaming	NP
talking over others	VP
kneeling	NP
a quaking or trembling body	NP
leaning back in a chair hands behind the head	VP
opening the mouth to say something then thinking better of it	VP
eyes that sparkle and gleam	VP
stiffness in the neck or jaw	NP
backing up	VP
scratching or rubbing skin	VP
running from the room or situation	VP
nervous behaviors fiddling with the hands moistening one’s lips	NP,VP
a tantrum screaming body flung down on the floor crying	NP,VP
judging others and their performance or contribution	VP
shaking one’s head	VP
fiddling with shirt sleeves	VP
headaches	NP
difficulties relating to others	NP
punching a wall or object instead of a person	VP
bleak observations about the world and the people in it	NP
wrinkling the nose	VP
using anger to feed strength	VP
repeatedly postponing or rescheduling events	VP
retracting the arms bringing them close to the torso	VP
rapt attention still posture	NP,ADVP,VP
the mouth becoming moist increased saliva	NP,VP
a polite manner	NP
over-protectiveness	NP
becoming quieter less animated	VP
a flat look narrowed eyes	NP,VP
referencing similar events from the past that did not pan out	VP
seeking comfort by touching one’s own hair neck or clothing	VP
assault or murder	NP
pulling out a weapon knife	VP
flight	NP
the mouth falling open	NP,VP
hugging kissing or other displays of affection	NP
putting distance between oneself and the requester	VP
mentally ordering oneself to calm down relax	VP
chewing at one’s lips or inner cheek and making them bleed	VP
a strong awareness of one’s surroundings	NP
always looking over the shoulder or around the next corner	ADVP,VP
failing grades at school lack of success at work	VP
a beaming expression glowing cheeks	NP
biting nails or picking at loose threads on one’s clothing	VP
a tendency to lie to cover up or excuse	NP
a tart tone snapping at others	NP
direct probing eye contact	NP
a hollowness in one’s chest	NP
a voice that loses its power	NP
justified possessiveness	NP
sifting memories for evidence to support innocence or challenge accusations	VP
apologizing for not showing immediate support	VP
talking too much or too fast	VP
clutching arms to one’s chest	VP
pressing a hand to the abdomen	VP
wanting to keep the amusement going by adding to it with others	VP
a distinct walk a fast-paced strut	NP,VP
replaying past events in order to understand	VP
emergence of fears phobias or ocd-like symptoms	NP,NP
a sense of entitlement	NP
shock disbelief	NP
sudden onset of nausea	NP
a flutter in the belly	NP
a voice that cracks	NP
texting during an event or while someone speaks	VP
searching for ways to get out of whatever is requested	VP
laughter that goes on for longer than normal	NP
a feeling of dread or hopelessness	NP
the sense that nothing will ever be the same	NP
dropping out of activities school or work on false pretenses	VP
stiffening hair on the nape of the neck	NP
tics a repetitive grimace a head twitch talking to oneself	NP,ADJP,S
squealing dramatically	VP
a lightness in the chest	NP
flaccid yet unwelcoming closed body language	VP
fiddling with jewelry or props	VP
clambering closer to a group or event	VP
blowing out the cheeks then releasing	VP
becoming unresponsive to questions or action	VP
cues for shame are naturally suppressed	NP,VP
kind words a soothing tone	NP,VP
a slow smile	NP
hands up palms toward the aggressor	VP
clapping someone on the back	VP
wearing clothes that are flashy or dramatic	VP
speaking slowly stretching out words what no way	VP
bald patches	NP
a need to justify one’s reluctance	DT,VP
keeping at a distance	VP
covering the hands with the face	VP
squeezing eyes shut	VP
avoiding the person or object of annoyance	VP
ribs squeezing	NP
acting normal to the rival’s face but talking negatively behind their back	VP
throaty laughter	NP
repeatedly returning to the scene where past events took place	VP
a quick disgusted snort	NP
uncertainty	NP
hands that clench and unclench	NP
a desire to go back and visit the past	NP
slinking away flight response	VP
wobbly legs	NP
eyes that are soft filled with an inner glow	NP,VP
moving away creating personal distance	VP
attempting not to stare	VP
teary eyes	NP
an inability to see a positive outcome	NP
stuttering choking out words	VP
negativity spilling into other parts of one’s life	NP
standoffishness	NP
accepting a negative outcome or realization	VP
drug and alcohol abuse	NP
speaking slowly to emphasize hurtful words	VP
smoothing and re-smoothing clothing	NP
a hand that cups the mouth	NP
a heaviness in the stomach	NP
muttering unkind things under breath	VP
pulling away from friends and loved ones	VP
voicing we’ll see comments	NP
forming hands into a steeple	VP
looking down when walking in public	VP
holding hands out and “weighing” them in the air	VP
making life-altering decisions career change a move etc as a way to start over	VP
a booming laugh	NP
an unforced laugh	NP
shortness of breath	NP
attention that snaps toward sound or movement	NP
slipping grades at school poor performance at work	NP,NP
moving closer into another’s personal space	VP
a positive outlook	NP
hyperventilation	NP
quick movements	NP
a painful tightness in one’s throat	NP
massaging the temples as if weary	VP
a sharp defined jaw line	NP
a smile that slips or appears forced	NP
spots flashing in one’s vision	NP
answering with a “maybe” response	VP
a bright outlook glass half full	NP,ADJP
neck bending forward	NP,VP
becoming accident prone bashing one’s hip on a desk corner etc	VP
neglecting everything else responsibilities friends family	VP
maintaining eye contact no matter how difficult	S,VP
an uncertain tone	NP
jeers taunts a cutting wit	NP,VP
an increased pulse	NP
self-talking to calm down to think straight	ADJP
sharing secrets and desires	VP
light sarcasm	NP
raising the eyebrows and offering a questioning gaze	S,VP
flashing a cold smile to show insincerity	VP
a body that’s constantly in motion nodding bobbing weaving pacing	NP,VP
increased adrenaline	NP
praying	VP
a loss of self esteem	NP
making promises to convince others of one’s worthiness	VP
sneaking glances at a clock or doorway	VP
hiding behind something against something	VP
soft head shaking	NP
fingers aching or tingling with the need to touch	NP,VP
shouting	NP
lethargically giving comfort to others rubbing their back patting their shoulder	VP
claustrophobia even in one who is not usually claustrophobic	NP
crying	NP
breaking eye contact and shrugging	NP
threatening violence	NP
entering another’s personal space to intimidate	VP
sobs trapped in throat	NP,VP
neglecting friends family work and other interests	VP
slumping into a chair	VP
squeezing someone’s arm to the point of bruising	VP
half-lidded eyes	NP
covering the face with hands	VP
repeatedly checking a phone for messages	VP
a quick glance at the source then away a person a clock a door	NP
pulling at one’s collar	VP
uncontrolled shivering and hand tremors	NP
a loss of inhibitions	NP
pulling or twisting at one’s hair	VP
a blank emotionless face	NP
rapid heartbeat and pulse	NP
puffy face or eyes	NP
showing comfort in the close proximity of others	VP
dishonesty with self and others	NP
spitting in the direction of the rival	NP
planting one’s feet in a wide stance	VP
temporary cessation of worries stress or actions	NP
denial shrugging forcing a laugh	NP,VP
a shiver that brings pleasure	NP
a palm pressed to the heart	NP,VP
cocking the head	VP
fidgeting having a hard time sitting still	VP
gritting one’s teeth pressing the lips tight	VP
wishing time would speed up	S,VP
a bowed head	NP
shoving hands in pockets	VP
pressing a palm over the lips to hold back a cry	VP
taking a step toward the person or object one wants	VP
tingling hands	NP
heavy arms the shoulders pulled low	NP,NP
pain in the back of the throat	NP
risk-taking behaviors hoping something will happen to balance the scale	NP,VP
chronic fatigue insomnia	NP
acting jumpy or jittery when near the source	VP
sitting with knees touching the other person’s	VP
glancing about for help an exit or escape	VP
holding one’s elbow while the opposite hand makes a fist against the mouth	VP
falling against another person	VP
lying on the grass to soak up the sun	VP
ulcers	NP
happy bursts of screaming shouting laughter squeals giggles	NP
repeatedly rubbing the face	VP
a hesitant nod	NP
ducking covering one’s head with the arms	NP,VP
crumpling under scrutiny	VP
muscles losing tension	NP,VP
tapping a finger against the tabletop in an effort to drive a point home	VP
turning away from the advantage and stalking off	VP
startling easily	NP
feeling watched or followed	VP
floundering hand movements	VP
repeating no and other negatives it’s not true	S,VP
providing an excuse to linger or move toward the source	VP
holding one’s sides	VP
a desire to discredit or take away the rival’s power	NP
forcing oneself to not look at or acknowledge the source	VP
increased blood flow to the extremities	VP
clasping the hands tightly a whitening of the knuckles	VP
a vein that pulses twitches or becomes engorged	NP
hugging showing affection	NP
an inability to focus or concentrate	NP
a feeling of breathlessness	NP
disbelief that others can’t see the truth	NP
rubbing the arms or legs	VP
poor listening skills	NP
a deliberate lowering of the head to study or stare	NP
thoughts centering on the facts of the situation	NP,VP
superiority	NP
staying busy with tasks to avoid dealing with the source of the emotion	VP
a stiff stance	NP
poor coloring dark circles under the eyes	NP
head cocked to the side	NP,VP
reckless behavior	NP
difficulty making decisions	NP
slamming a door	VP
hitching breaths	NP
placing a hand against the breastbone	VP
googling the suspect	VP
hesitation before speaking as if weighing words	VP
a loss of body control weak muscles having a hard time staying upright	NP
an inability to eat	NP
moodiness	NP
starting at noises	VP
clutching at another person for support	VP
self-congratulations	NP
going silent disengaging from conversation	VP
profuse sweating	NP
a lump in the throat	NP
speaking without hesitation when answering	VP
needing to leave the room	VP
closing one’s eyes to shut everything out	VP
sniffing back tears	VP
raising one’s eyebrows and giving a glassy stare	VP
touching or holding the object close	VP
decreased interaction with the world at large	NP
the body crumpling in on itself	NP,VP
taking deep calming breaths	VP
helpfulness	NP
breathing through the nose audibly to others	VP
dieting or working out in an effort to improve one’s appearance	NP
holding arms up in a “victory v”	VP
stumbling staggering	NP
facing the object straight on	VP
seeking others’ opinions as a form of validation	VP
asking questions about the fallout how did she take the news	VP
dry heaving	NP
pretending to faint	VP
sputtering gaping	NP
pressing fingers to smiling lips	VP
closing the eyes to savor the experience	VP
self blame	NP
mental numbness	NP
snapping under pressure screaming yelling hitting others	VP
a restless stance	NP
briefly closing one’s eyes	ADVP,VP
lightly rapping one’s fingers as if to internal music on a leg or other surface	VP
hair hanging in face hiding the eyes	NP,VP
writing and sending letters email and gifts	VP
trying to shake or roll tension from the shoulders	VP
direct or intense eye contact	NP
a sense of betrayal that rocks the mind to the very core	NP
rubbing at the eyes hiding redness or tears from others	VP
asking for reassurance from others	VP
finger twitches compulsive and repetitive movements	NP,VP
dry mouth	NP
tilting the head from side to side weighing choices	VP
making an excuse to leave	VP
bargaining	NP
tingling skin as sweat forms	VP
mentally fixating on the recent success	ADJP
avoiding social situations	VP
a high chin neck exposed	NP,VP
rapid blinking that leads to a wide-eyed look	NP
trying to pinpoint the source of discomfort	VP
a sudden lightness or giddiness	NP
wrapping arms around self	VP
relaxed posture	NP
a determination to have or own	NP
leaning in to talk or listen	VP
attentiveness to tasks or people connected with one’s goal	VP
letting him blow off steam or talk trash about others	VP
rapid speaking babbling	NP
shunning or offering evasive answers	VP
making a display of engaging in conversation with others	VP
pursing one’s lips	VP
purposefully not looking at the source	ADVP,RB,VP
joking comments to deflect	VP
taking on traits or mannerisms of the subject	VP
lifting the shoulders as if to hide one’s neck	VP
picking at food or finding food tasteless	VP
choosing a safe spot to wait	VP
feeling like the head is spinning	VP
difficulty swallowing	NP
rash decision-making quitting a team storming out of a party	NP
attacking a task diverting one’s energy	VP
downplaying one’s own comfort level to make others feel better	VP
rigid body posture	NP
hands gripping elbows	NP
benign risk taking for fun	NP
acting hyper immature or foolish out of a sense of fun	NP
stalking	VP
a heart that is breaking or aching	NP
a slower heartbeat	NP
crossing the arms tightly over the chest	VP
pigeon toes tilted inward	NP,VP
adopting a silly love-struck tone when communicating	VP
thrusting oneself into the middle of an event or debate	VP
watching from a safe distance	VP
looking for a fight	VP
a rise in vocal pitch	NP
rubbing the jaw or back of the neck	VP
putting an arm around someone’s shoulders	VP
nodding along as another speaks	VP
choosing to spend time in environments that are a reminder of success	VP
ignoring distractions	VP
nightmares	NP
a lack of tension and stress that almost equates to a feeling of nothingness	NP
falling into a routine	VP
a desire to share achievements with others	NP
waving something off	VP
hands up in a defensive stance	VP
addiction to medication	NP
a light squeeze during a handshake	NP
tugging clothes more firmly into place closing an open jacket	VP
stomach upset poor diet weight loss	NP
would simply display itself as fear	VP
making odd noises in the throat	VP
preoccupation with one’s achievements or successes	NP
steady eye contact	NP
fiddling with a ring or button to avoid eye contact	VP
passing out from a stress overload lack of oxygen or both	VP
wrinkling the brow	VP
pushing food around on a plate	VP
shouting screaming swearing	VP
uncertainty over choices made	NP,VP
becoming inarticulate	VP
crying blubbering hitching sobs	VP
fidgety movements scraping the hair back curling one’s fingers	NP,VP
claiming that the victim was partly responsible	VP
a complete life change taking up charity work finding god etc	NP
crossing arms in front of chest	VP
head shaking	NP
possessiveness	NP
crossed arms a wide stance	NP
difficulty sitting still	NP
staring down at one’s feet	VP
snapping at people	VP
euphoria exhilaration	NP
a closed-off stance crossing the arms making oneself small averting the head	NP
inserting oneself into conversations	VP
vacant eyes	NP
passing the credit to someone else	VP
making oneself small hugging oneself squatting down fetal position	VP
regret for a past action	VP
spouting inane or irrational arguments	VP
pulling someone else into the situation to divert attention and allow one to exit	VP
enduring hardship to be with the love interest or make them happy	VP
curling hands into tight fists	VP
apt dialogue that sums up the situation perfectly	NP
seeing and hearing things that aren’t there	VP
unsmiling humorless	NP
holding onto a chair or wall for support	VP
not meeting anyone’s gaze	NP,VP
negative thinking	NP
holding the stomach	VP
offering to handle the problem instead	VP
a tightening in the chest	NP
holding onto someone’s hand for longer than necessary	VP
bulky or dull clothing choices	NP
increased sweat output during uncomfortable moments	VP
pressing palms to cheeks	VP
increased awareness of one’s environment	NP
shuffling backward	VP
a need to leave but not understanding why	DT,VP
keeping arms and legs in close to the body	VP
tactfully offering alternative suggestions	VP
skin bunching around the eyes a pained stare	NP
rocking in one’s seat	VP
a quick tensing of the body	NP
hands up backing away with a shudder	VP
trailing off when speaking	VP
sore muscles stiffness cramping	NP,VP
sharing finances and possessions	NP
a tightness in the face	NP
eyebrows gathering in	NP
bumping shoulders	NP
obsession with the person or event associated with the regret	NP
being generous to others in order to curry favor	VP
lightness in the limbs	VP
anger or hurt at being put in this situation	NP
an unclean home room or office space	NP
a slight head nod	NP
a strained or tense voice	NP
stroking one’s arm as a surrogate for the object of desire	VP
throwing something into the air—a hat books confetti helmet	VP
tingling warmth in the limbs	VP
eavesdropping	NP
sitting at the edge of a chair	VP
lifting a single eyebrow	VP
playful shoving and grabbing	NP,VP
jumping to a course of action without thinking things through	VP
an inability to see the subject’s flaws or faults	NP
swatting at the air	VP
hitching chest	NP
failing grades	NP
using the body to nudge push or block line jumpers	VP
fidgeting as if movement will make things go faster	VP
arrogance	NP
flinching away from touches	VP
a tingling or electrical jolt at accidental touches	NP
a distant unfocused smile	NP
sluggish heartbeat	NP
listening intently while ignoring discomforts cold rain heat	VP
running the hands through the hair flipping hair back	VP
reaching or touching in hopes of gaining help or favor	VP
witty commentary	NP
mimicking boredom slumping in one’s seat tapping a pencil	VP
asking questions	VP
nodding but with a tight expression to show one is not fully committed	UCP
risk taking	NP
a sense of release when confronting the suspect	NP
a heart that feels like it’s shrinking	NP
offering something noncommittal let’s put that in our back pocket for now okay	VP
pressing one’s knees together	VP
projecting the voice reinforcing who has the upper hand	VP
making an “x” motion with one’s hands	VP
refusing food or drinks prepared by others	VP
reining in one’s emotions before damaging relationships	VP
facial tics	NP
pain in the chest lungs or throat	NP
nausea	NP
smiling and nodding	VP
becoming easily distracted	VP
adjusting one’s clothing	VP
fists that shake	VP
shallow breathing	NP
relishing opportunities to talk or engage mail deliveries etc	VP
blowing out a breath that rattles the lips	VP
rubbing or pinching the bottom lip	VP
humming whistling singing	VP
fiddling with things to keep hands and feet from twitching	VP
covering the mouth with a hand	VP
a restless stance pacing	NP
huddling in the corner behind or against something	VP
a red face and neck	NP
hiding the hands in the pockets	VP
a pained or watery gaze	NP,VP
the mouth turning down	NP,VP
changing the subject	VP
answering with a small nod	VP
spittle flying while yelling	NP,VP
elation at delivering a blow to an opponent through dialogue or action	NP
stumbling back a step	VP
purposely ignoring someone’s conciliatory efforts	ADVP,VP
launching into a flurry of activity	VP
raising one’s palms	VP
carefully controlling one’s voice and tone	VP
a preoccupation with one’s appearance	NP
false smiles	NP
depression	NP
bringing up everything that could go wrong	VP
offering a small display of anger	VP
rapt attention nodding	NP
heartburn or other digestive issues	NP
slowly walking closer but keeping arms close to the body	VP
rapid blinking	NP
quivering with the effort of controlling oneself	VP
reading into things over-analyzing	VP
moving into someone’s personal space	VP
a wrinkled brow	NP
adding an adornment a pin fancy hat a bright scarf solely for appearances	VP
focusing solely on the rival’s negative attributes	VP
closed eyes the head tipped back	NP,NP,VP
a hand fluttering to the lips or neck	NP,VP
fearlessness	NP
fussing over the person’s appearance while speaking in encouraging tones	VP
praying bargaining	NP
asking are you sure questions	SINV
sweating profusely	VP
easy breaths	NP
bragging obsessively talking about an achievement or material object	VP
a wide-eyed look that gets others dissolving into laughter again	NP
a guttural roar	NP
holding oneself tight self-hugging	VP
letting out a whimper	VP
an utter lack of self-confidence	NP
exhaling while the eyes look up	VP
committing crimes against the enemy	VP
narrowed eyes when it’s necessary to focus on something besides the source of relief	VP
walking in jerky self-contained strides	VP
asking questions to elicit more information	VP
avoiding the source	VP
perfectionist tendencies	NP
ignoring or overlooking any flaws associated with the pride item	VP
a hard obvious swallow	NP
empathy for the other party and what they are going through	NP
anger and frustration	NP
a wrinkled nose	NP
drawing in breath then releasing it	VP
sedate mannerisms minimal or economical movement	NP
alert gaze	NP,VP
rolling the eyes	VP
fixating on a person or situation to the detriment of other relationships	VP
light-hearted teasing	NP
hands moistening	NP
licking one’s lips	VP
trying to fade into the background at social events	VP
wishing to be somewhere else	VP
shoving people aside to reach the enemy	VP
stuttering and mispronouncing words tremors in the voice	VP
a hand covering the mouth rubbing the chin	NP
using a quiet voice	VP
a narrowed focus allowing for sole concentration on the other person	NP
flirtatious talk or nonstop talking	NP
the desire to flee	NP
engaging in new and satisfying hobbies and interests	VP
a self-deprecating laugh	NP
bumping pushing or shoving to get closer	VP
crumpled body posture	NP
underestimating others	NP
repeating a statement as a question	VP
a grimace and a slight shake of the head	NP
gazing with focus	VP
flight response	NP
tingling skin	NP
scrambling to reverse what was said or done	VP
pressing a fist to the mouth	VP
name-dropping	NP
avoiding the person or issue	VP
roaring in the ears	VP
a strained or faked smile	NP
a change in the pitch tone or volume of the voice	NP
dissatisfaction with what one does have	NP
loss of interest in one’s personal appearance	NP
making a slight growl or noise in the throat	VP
seeking perfection	VP
starting rumors acting catty	VP
thinking irrationally	VP
loss of bladder control	NP
contentment	NP
weeping	VP
a deep gratifying sigh	NP
nodding the head as if one is not surprised at all	VP
believing that one has failed	VP
lying in the other’s lap	VP
speaking at the air rather than make eye contact with others	VP
stiffening and going still	VP
stepping lightly skipping	VP
smiling politely not genuinely	VP
generosity that displays power hosting charity functions etc	NP
tics and tells a throbbing forehead vein fingering a collar	VP
trying to “one-up”	VP
leaving the situation or presence of an enemy	VP
angrily dismissing someone from one’s presence	VP
surveying the finished product with a pleased expression	VP
tapping the fingers together	VP
decaying physical health hospitalization	VP
seeking power as a means of self-validation	VP
shoulders curling a bent spine	NP,VP
dropping the head eyes closed	VP
gloating when the rival falters or shows weakness	VP
asking questions for clarification	VP
poking a tongue lightly into the cheek and inhaling a long breath	VP
changing one’s lifestyle to accommodate new beliefs recycling moving to the country	VP
avoiding the victims shame	VP
sagging posture	NP
delaying tactics suggesting time to review options etc	VP
turning one’s attention to someone else	VP
taking deep breaths to calm oneself	VP
fingers touching parted lips	NP,VP
narrowing the eyes squinting	VP
committing too quickly to anyone who shows interest	VP
heartbeat racing nearly exploding	NP
feeling one’s pulse in the throat	VP
fumbling for words	VP
overreacting to noise	VP
pain in jaw from clenching teeth	VP
an increased awareness of one’s body and what goes into it	UCP
sighing dejectedly	NP
ducking the head to hide one’s expression	VP
a ruddy complexion	NP
over-estimating one’s capabilities	NP
an impatient snort or sneer	NP
exuding calm and focus	NP
mental insults	NP
consuming antacids	NP
high color a flushed appearance	NP
a tingling that sweeps up the back of the neck and across the face	NP
attempting to think positive thoughts about the rival	VP
protective posture chin to chest arms holding the body tight	NP
heartbeat seeming to slow or stop momentarily	NP,ADJP
negativity	NP
jumping to the defensive	VP
momentarily forgetting all else	VP
fanning self	NP
big movements waving arms while talking counting out arguments on fingers	NP,VP
an inability to connect with others due to a lack of trust	NP
using humor to lighten the moment	VP
eyebrows raising	NP
trying to slow one’s breathing	VP
wanting to be left alone	VP
pointedly ignoring another person or situation that draws others in	ADVP,VP
ears that turn red	NP
clenching teeth	NP
eyebrows lowering and pinching together	NP
holding the hands in the lap	VP
exuberant responses jumping up and down shouting running hysterical crying	NP
substance abuse	NP
moving about sitting then standing choosing a different chair	VP
uttering a soft curse or thanking god	VP
fidgeting	VP
issuing a challenge to the rival that contains an element of risk	VP
self-violence scratching cutting pulling hair	VP
desperation to balance the scales or resolve the situation	NP
dropping out of clubs and groups	VP
fantasizing	NP
light words delivered in a serious tone	NP
a vacant stare	NP
a watery smile that’s forced into place	NP,VP
telling someone that they aren’t alone how things will work out	VP
arguing without aggression only to provide insight	VP
feet shuffling	NP
turning away to collect oneself	VP
lying or doing whatever it takes to keep a shameful secret	VP
obsessively checking the phone to see if the love interest has called	VP
feeling broken inside	VP
pulse speeding heartbeat pounding	NP,VP
aggressive workouts	NP
tears sadness	NP
numbness in mind and body	VP
rubbing the hands together	VP
movement is slow jerky	NP,VP
thrusting a fist into the sky	VP
wanting to hurt someone to see blood	VP
a compulsion to flee	NP
chuckling or cackling	VP
speaking in a bubbly or loud tone	VP
choosing negative relationships over being alone	VP
the sensation of being flooded with warmth	NP
winking or giving someone an easy nod	VP
trembling	VP
muttering under one’s breath talking to oneself	VP
a sensation of increased strength	NP
seeking any excuse to avoid what is to come	VP
touching the base of the neck	VP
tightened jaw	NP
eye rolling	NP
hot or gummy eyelids	NP
tunnel vision	NP
covering one’s ears	VP
inability to make any decision on one’s own	NP,ADJP
rhythmic movements swinging one’s legs back and forth etc	NP
locking hands together to force stillness	VP
uncontrollable body tremors	NP
increased internal temperature and heartbeat	NP
dragging the hands through the hair repeatedly	VP
arms hang at the sides slack	NP,VP
sharing a look with an ally raising the eyebrows to convey a message	VP
a falling or dropping sensation	NP
eyes squinting lit with an inner glow or twinkle of mischief	NP,VP
seeking comfort in unhealthy ways	VP
running hands through one’s hair or flipping the hair back	VP
avoidance of social situations	NP
swearing and offering insults	NP
expressing a greater interest in the happiness of others	VP
sparkling eyes a weightless gaze	NP,VP
adopting a pondering pose hand clasping the chin as if struck by deep thoughts	S,VP
a runny nose	NP
seeing danger symbols in everything	VP
ignoring the law or society’s values	VP
an inability to sleep or relax	NP
flight reaction	NP
asking questions to gain more insight	VP
tsking or making a noise in the throat	VP
calling attention to another’s weaknesses	VP
an uneven step	NP
frequently moistening the lips	ADVP,VP
darting glances at the person wronged	NP,VP
scrubbing a hand over the face	VP
a churning stomach	NP
fantasizing or building up the event far beyond its reality	VP
making preparations or conditioning the body	VP
crossing the arms	VP
daydreaming or fantasizing about the object	VP
withdrawing from groups activities and social interaction	VP
speaking in short phrases	VP
resorting to the physical pushing shoving	VP
a flat monotone voice	NP
a wide stance	NP
looking from lowered lids	VP
planning for obstacles and strategizing ways to overcome them	VP
randomly changing the topic	VP
crossing one’s arms holding onto one’s shoulders	VP
knees pulling together	NP
clumsiness due to rushing knocking things over bumping tables	NP
slumped shoulders	NP
lips that are slightly parted	NP
pinching or tugging on the bottom lip	VP
whispering in hushed excitable tones	VP
leg muscles tightening the body ready to run	NP,VP
a glassy stare a glazed look	NP,VP
tension headaches	NP
seeking corners in confined spaces	VP
sticking a tongue out	VP
perfectionism	NP
blowing out a noisy breath	VP
fight reaction shoving the initiator delivering a punch to release anxiety	VP
inattentiveness	NP
vandalism of one’s own things	NP
not responding to jokes or personal exchanges	RB,VP
suggesting someone else to help or act instead	VP
baiting the other person	VP
shaking	VP
a distant or empty stare	NP
workaholic tendencies	NP
feeling like one’s insides are quivering	VP
quivery smiles	NP,VP
statements suggesting impatience here i’ll do it	NP,ADVP,VP
ignoring the target	VP
hypersensitivity to noise crowds activity	NP
spitting at someone or in their direction	NP
surrender if breaking point is reached	VP
biting criticism and belittlement	VP
forced laughter	NP
a gentle tone using words the other person wants to hear	NP
restless legs	NP
difficulty sleeping	NP
lightness in the chest	VP
squealing screaming shouting whooping hollering	VP
irritability	NP
spitting in the direction of the one provoking contempt	NP
a pensive expression	NP
excessive safety precautions extra locks guard dogs video surveillance	NP,VP
shunning the source	VP
a need to hide or flee that supersedes all else	DT,VP
avoiding the painful subject denial	VP
rumpled unwashed clothes	NP
rasping breaths	NP
dark or heavy observations	NP
leaning forward sliding one’s chair closer	VP
hiding behind one’s bangs	VP
an unhurried exit	NP
a sudden coldness that hits at the core if surprise is negative	NP
bullying cyber trolling	VP
turning attention away from oneself	VP
wincing	NP
strong eye contact	NP
biting the lip	VP
the mind replaying what was seen in agonizing detail	NP,VP
languid movements	NP
shoulders hunching slightly	NP
muscles bunching	NP
obsessive thoughts on how to fix the situation	NP
jumping to extreme anger with little provocation	VP
holding a hand close to the face while speaking	VP
crying sobbing wailing	VP
terror by nature is almost impossible to suppress or hide any attempt to hide terror	NP,VP
overusing ums ahs and other verbal hesitations	NP,VP
speaking rapidly with the intent of maintaining the status quo	VP
nausea or a heaving stomach	NP
the heart beating banging or hammering	NP
poor communication with others	NP
wrenching an enemy’s arm to stop them from leaving	VP
an inability to focus on anything but the internal conflict	NP
heavy footsteps	NP
beating one’s fists against something to the point of injury	VP
a pounding heart	NP
an inability to meet another’s eyes	NP
a sore throat from pleading crying begging	NP
nodding while the subject speaks	VP
raising a hand immediately to be called on	VP
a pounding heartbeat	NP
shaking one’s head as if in denial	NP,VP
false modesty	NP
loud breaths a heaving chest	ADVP,VP
telling oneself that it doesn’t matter	VP
fatigue	NP
chills	NP
dancing in place	VP
limbering up shoulders and neck as if readying to fight	VP
racing heartbeat drumming in the chest	VP
restlessness sitting then standing	VP
breathing that grows heavier louder	NP
adrenaline spikes	NP
deriving pleasure from violent fantasies involving an enemy	VP
being at a loss for words	VP
slapping one’s knees or thighs	NP
holding in a breath	VP
wet eyes	NP
a glance that returns to the source of irritation	NP
demanding immediate action	VP
positive outlook and thinking	NP
worrying that others will feel let down or disappointed	VP
telling the unvarnished truth	VP
shifting back and forth	VP
a confrontational stance	NP
seeking revenge	VP
expressing enjoyment of the senses swaying to music savoring food	VP
emotional displays that seem forced or false	NP
lingering touches	NP
excessive saliva	NP
hypersensitivity to touch and texture	NP
sucking in a quick breath	VP
committing assault or murder	VP
stiff posture an air of readiness	NP
wanting to be held	VP
humming that feels forced or fades quickly after it starts	NP
repeating the truth as one sees it and sticking to it	VP
replaying a scene or event over and over in one’s mind obsessing over it	VP
pursing the lips	VP
a still demeanor to aid in observation	NP
a disconnect with one’s life or society	DT,VP
forcing oneself to remain in the presence of the annoyance	VP
withdrawing from the conversation	VP
hands tightening into fists	VP
verbalizing the ups and downs that led to this point	VP
avoiding a person or place	VP
camaraderie with others	NP
muscle strain	NP
insulting the target in front of others	FRAG
poor balance	NP
a curling lip showing the teeth	NP
manipulation	NP
quick sharp movements swiping tears from cheeks shoving hair out of eyes	NP
moving about being unable to settle in one place	VP
a furrowing brow	NP
waving a hand in dismissal	VP
a hand that lifts towards someone then lowers	NP
hardening of the stomach	VP
ribs squeezing tight	NP
getting the giggles	VP
plucking at clothes to cool down	VP
watching romantic movies	VP
isolation	NP
thoughts that freeze	VP
picking on someone weaker for a sense of power and control	VP
ulcers and other digestive disorders	NP
a tendency to look down	NP,VP
rapid lip movement as one tries to find the right thing to say	NP
making demands	VP
an expression that crumples at other peoples’ affection displays	NP
begging people to stop	VP
trying to evade notice slumping in a chair withdrawing from conversation	VP
obsessing over one’s own flaws and shortcomings	VP
feeling that life isn’t worth living without the advantage	VP
expressing concern	VP
taking one’s anger out on innocent bystanders	VP
clasping hands to the chest	VP
a visible flush in cheeks	NP
chain smoking or drinking heavily	NP
grabbing onto a friend’s arm	VP
tilting the head and pausing	VP
weakness in limbs especially the knees	NP,NP
a mental break humming rocking hands over ears or eyes	NP
using one’s hair to hide an interested glance	VP
arms straight hands locked into fists	NP,NP,VP
a slackened mouth displaying shock	NP
choosing a seat in the back of the room or away from others	VP
turning away negative surprise	VP
the belief that one is no longer required to live by the laws of society	NP
lips parting slightly	NP,VP
fussing with appearance brushing away lint checking fingernails	VP
asking for time to make the decision	VP
pretending to not have heard or seen	VP
kissing up to gain approval through association	VP
feeling betrayed	VP
offering a wave	VP
a painful lump in one’s throat	NP
excessive sweating	NP
showing a sudden interest in other things	VP
irrational reactions to inconsequential things	NP
a weighed-down feeling	NP
deflecting questions or concern	VP
pulling or tugging at one’s clothes	VP
holding one’s breath	VP
a hyper-awareness of the body	NP
preparing early often hours or days before needed	VP
finding something close to hand to use as a weapon branch rock	VP
a shallow sigh	NP
body shielding turning at an angle	NP,VP
bending the neck forward	VP
posture that bends or crumples	NP
attempting to engage socially but with wary and darting eyes	VP
visible sweating	NP
rigid posture cords twanging in the neck	NP,VP
closing one’s eyes in an attempt to stay calm	VP
gritted teeth	NP
muttering please repeatedly under the breath	VP
actively wishing for harm or misfortune to happen to another	VP
requesting more time to consider in order to delay	VP
spitting or throwing up	NP
a belly laugh	NP
jabbing a finger in someone’s face	VP
crying sobbing hitching breaths	VP
a smile that is frozen manic	NP
spending large periods of time in the past	VP
leaving the room or situation to clear thoughts	VP
difficulty staying still	NP
placing hands on the hips	VP
a tendency to judge people according to one’s personal measuring stick	NP,VP
eyes that glow	VP
taking a step closer fists clenched	S,ADVP,VP
drinking until passing out to forget	VP
touching one’s fingertips to one’s lips	NP,VP
not paying attention to one’s surroundings	VP
arriving late calling in sick or refusing work shifts to avoid the source of resentment	VP
holding a palm up to stop someone from dumping on more worry	VP
heart palpitations	NP
backing away with raised hands	VP
sidelong glances while keeping the head still	NP,VP
pain in the jaw	NP
looking downward	VP
glancing at others to see what they think	VP
reaching	NP
a disheveled look hair out of place clothes rumpled	NP,ADJP
an edgy twitchy feeling	NP
gasping	NP
rushing one’s words	VP
making excuses for not agreeing immediately	VP
body temperature jumping up	NP
pretending to be unaware of a loud argument or uncomfortable situation	VP
deflecting blame	VP
attempting to change one’s appearance	VP
tremors in the hands and fingers	NP
weak legs	NP
rubbing at one’s hands	VP
tingling limbs	NP
curling one’s toes	VP
flashy or dramatic clothing	NP
masking weakness with excuses sorry i stood up too fast	NP,ADJP,S
using exaggerated movements to draw attention to oneself	VP
keeping one’s face blank	VP
flinching starting	NP
rejecting opportunities to revisit the past reunions trips to the old house or hometown	VP
feeling a sense of comfort from a full mailbox even junk mail	VP
jotting notes as a way to delay answering	VP
a sweaty disheveled appearance	NP
eye contact dropping if one is unsure or lying	NP
heart disease stroke	NP
flirting	VP
muttering	NP
pressing a fist against the mouth and puffing out the cheeks	VP
arms hanging limply at the sides	VP
staring someone down to frighten them	VP
satisfied catlike stretches	NP
tugging a hat down low or pulling a hood over the head	VP
being easily distracted by other things tv a hot girl walking past	VP
licking the lips	VP
a pasted-on smile	NP
an inability to maintain long-term relationships	NP
being with others with no need to fill the silence	VP
bringing a shaky hand to the forehead	VP
rising color in one’s cheeks	NP
spinning in a wild circle	ADJP
offering an exchange take me instead or i’ll go you stay	VP
color draining from the face	NP,VP
rubbing a hand against the front of one’s shirt over heart	VP
heightened emotions a feeling of being on edge	NP
a growing interest in spiritual or religious philosophy	NP
forgetting what one was about to say or do	VP
wanting to be around people with the same opinions	VP
jumbled thoughts	NP
a strong desire to touch hold and own	NP
impaired decision making	NP
wanting to flee or hide	VP
narrowing eyes having an intense focus	NP,VP
compulsive behaviors	NP
laughter with an edge	NP
weight gain	NP
making a noise in one’s throat	VP
shoulders that curl over the chest	NP
revisiting the source or place of accomplishment to feel empowered	VP
suggesting a vote of majority	VP
eyes that don’t seem to blink often enough	NP
elevated pulse	NP
drab colorless clothing choices	NP
looking past someone rather than at them	VP
a voice that drops or goes quiet	NP
going on the offensive and verbally attacking the accuser	VP
short jerky movements	NP
stiffening posture	NP
one’s smile going stiff in an effort not to lose it negative	NP,VP
agreement murmuring affirmations	NP
repeatedly running the hands through the hair	VP
pulling someone into a side hug	VP
sending the mind “somewhere else”	S,VP
desiring to live in the past or be alone	VP
citing that luck was involved but not meaning it	S,VP
looking down	VP
a biting remark	NP
nervous habits picking off nail polish humming under the breath	NP,VP
attempting to openly discredit or blackball the suspect	VP
placing hands in one’s pockets	VP
speechlessness	NP
bent posture	NP
quivering breaths	NP
increased swallowing	NP
doing things to appear normal ordering food but not eating it	VP
a soft tap to the arm a pat on the back	NP
glowering	NP
wide eyes	NP
stalking away from someone leaving in a huff	VP
a hunched posture	NP
biting the inside of the cheek	VP
cringing or shaking	VP
knees loosening and feeling weak	NP,VP
a wide stance chest thrust out	NP,VP
over-the-top support i’m with you 100 i absolutely agree	NP
increased fidgeting an inability to remain still	VP
poking one’s tongue into the cheek	VP
a need to sit down	DT,VP
a racing heartbeat	NP
petting or stroking one’s own hair comfort gestures	VP
denial diversion of blame to others	NP
clutching comfort items a necklace charm phone etc	VP
looking down to hide a grin	VP
the face neck and ears feeling impossibly hot	NP,VP
using a friend’s shoulder as a shelf for your elbow	VP
standing away and reaching in with one hand	VP
images of what-could-be flashing through the mind	NP,VP
embarrassment	NP
displaying poor balance and coordination	VP
biting down on a smile	VP
eyes that appear wet	NP
abrupt movement causing a chair to tip or scuff the floor loudly	NP
citing possible repercussions	VP
increased thirst	NP
speaking through the teeth with forced restraint	VP
staring	VP
averting the face	VP
thoughts of suicide	NP
a grim twist to the mouth	NP
infusing one’s speech with positive words	VP
muscle fatigue and soreness	NP
manic behavior hair pulling ocd paranoia	NP,VP
a slack mouth	NP
keeping mementos from the happy time	VP
stress headaches	NP
lank or unwashed hair	NP
focusing one’s gaze elsewhere in an attempt to ignore	NP,VP
crossing the arms forming a barrier to others	VP
lowering the brows	VP
hunched posture and a drooping head	NP
jeering running someone down bullying	VP
positioning oneself to create a barrier moving behind a table etc	NP
bragging showing off	NP,VP
crumpling sinking to the ground	VP
extreme focus on problem solving	NP
a willingness to believe that everything will be all right	NP,VP
grabbing onto someone	VP
post traumatic stress disorder	VP
a too-quick smile	NP
holding back a scream or cry	VP
not showing up for work or school letting grades slip	RB,VP
agreeing then not following through	VP
fidgeting in a chair	VP
tightening the grip on whatever is being held	VP
sweeping arm gestures	NP
fluttery stomach	NP
a hanging head	NP
shuffling footsteps	NP
skin flushing	NP
muttering negatives no or i don’t want to	S,CC,S
avoiding familiar places and activities	VP
flushed or mottled skin	NP
unnatural silence	NP
slam-dunking trash into a barrel after a game or event	NP
dull eyes	NP
pulling out a cell phone to record the event	VP
asking questions to glean information without giving away disbelief	VP
a forcibly calm demeanor	NP
calling in sick	VP
pupils appear dilated	NP,VP
fatigue or insomnia	NP
fixation on self-improvement education or goals leading to achievement	NP
staring down at one’s empty palms	VP
a compulsion to look back when fleeing	NP
thinking about worst-case scenarios	VP
crossing one’s arms showing closed body posture	VP
standing back and observing before jumping in	VP
masking fear with a reactive emotion anger or frustration	VP
speed-talking with others heads close together gossipy	NP,VP
stubbornly sticking to one’s belief even if it doesn’t make sense	VP
a hesitating nod	NP
closing one’s eyes to more clearly recall the memories	VP
noisy breathing	NP
loss of self confidence	NP
quaking shoulders	NP
fidgeting with jewelry in order to draw attention to it	VP
bouncing a curled knuckle against the mouth	VP
stopping mid-stride or stumbling	VP
heavy or shaky breathing	NP
bargaining pleading	NP
berating oneself	VP
eyes widening yet brows are furrowed	S,CC,S
holding a hand over the mouth to cover a smile	VP
hunched or rounded shoulders	NP
a lack of interest in one’s own appearance or wellness	NP
wishing one could go back and change what happened	S,VP
a bark of laughter	NP
acting as if rules do not apply or one is above the law	VP
a voice choked with tears	NP,VP
straightened legs knees uncrossed	NP,VP
a tone that lacks strength or vitality	NP
rough handling of objects	NP
raised body temperature	NP
a sheen of sweat on the cheeks chin and forehead	NP
sagging against a wall or person	VP
touching one’s fingertips together tapping forming a steeple	VP
backing up against a wall sliding into a corner hiding	VP
dominant behavior invading another’s personal space standing while others sit	NP
begging someone for details an answer for a look at something	VP
employing clichés this too will pass keep your chin up etc	VP
stomach troubles or ulcers	NP
practicing a skill	VP
reacting with anger screaming slapping hitting	VP
clutching an item tightly or holding it as a shield	VP
seeking reassurance from others	VP
leaning away	VP
trusting one’s gut feelings	VP
speaking with a soft voice or tone	VP
a pale or sickly complexion	NP
pointing with an index finger	VP
meaningless gestures scrutinizing cuticles checking for split ends	NP
hesitating mid-action while reaching for something or pulling out a wallet	VP
avoiding conversations about the subject	VP
a bowed spine	DT,VP
denial	NP
shaking the head	VP
talking to oneself under the breath	VP
smiles that don’t reach the eyes	VP
arms crossing one’s chest closed body posture	NP,VP
planting the feet wide apart	VP
focusing on one’s shoe scuffing at the ground etc rather than giving due attention	VP
a need to sit down and reflect	DT,VP
crying with the person	VP
nodding or leaning in actively showing interest	VP
cutting oneself	VP
attempting to reason or glean more information	VP
clutching at a sweater purse or necklace for comfort	VP
showing a talkative nature and courtesy with strangers	VP
asking for the good news to be repeated	VP
hands that go limp	NP
licking the lips gulping down water	VP
biting the fingernails	VP
conditioning for the task in advance	VP
sharp hand movements jabbing a finger for emphasis etc	NP
closing the eyes and covering the mouth	VP
wiping at the mouth	VP
uncontrollable shuddering or shivering	NP,VP
panic symptoms when put on the spot	NP
slipping hands into pockets	VP
pleading bargaining please stop	VP,VP
ignoring the pain or suffering of others	VP
flinching at noise or from being touched	PP
an inability to forgive oneself	NP
lifting the chin	VP
a slight moan	NP
an unshakeable sense of something being wrong	NP,VP
making sacrifices to offer comfort cancelling plans being late for an appointment	VP
rubbing one’s arms and looking around	VP
negative language you don’t know what you’re talking about	NP
making pointed suggestions to alleviate the annoyance	VP
tugging at clothing jerking down a cuff forcing a zipper up	VP
glancing around as if looking for answers	VP
moving back slightly increasing one’s personal space	VP
flinching when touched	VP
rolling one’s shoulders	NP
flipping one’s hair in annoyance	VP
satisfaction with the world at large	NP
emphatically saying no	VP
start-and-stop gesturing reaching then hesitating changing direction mid-stride	NP
a deliberately quiet exhale	NP
a relaxed appearance	NP
a desire to erase all distance	NP
opening one’s mouth to argue then stopping	VP
thoughts of escape	NP
sagging facial features	VP
squinting looking inward	VP
spending minimum time with the suspect before finding a reason to leave	VP
voice is tearful or breaks	NP,VP
rubbing the back of the neck	VP
turning slowly unwillingly	VP
food and drink lacks taste or does not bring enjoyment	NP,VP
toneless responses	NP
gratitude at having risen above the rest	NP
narrowing one’s stance bringing the feet together	VP
shuffling steps	NP
thrusting the chest out	VP
fiddling with an object to keep the hands busy	VP
irrational thinking	NP
steady eye contact large pupils	NP
waving people away	VP
twisting or pulling at clothing	VP
requesting more time to reflect	VP
talking to others about similar experiences or situations	VP
cocking or tilting the head	VP
wanting the pain to end	VP
quirking an eyebrow and smiling	VP
snorting laughing	NP
offering up prayers on their behalf	VP
bulging eyes an inability to blink	VP
trying to recreate a past event burning the same scented candle wearing the old clothes	VP
the lips pressing together pursing or flattening	NP
not smiling or offering a smile that fades quickly	RB,VP
increased awareness of sensory information	NP
reliving past events	VP
visible shakiness	NP
biting the inside of the lip	VP
tilting the head in a side-to-side rhythm	VP
holding the stomach as if pained	VP
a lack of productivity	NP
a loud voice	NP
smoothing the front of a shirt or tugging down the sleeves	VP
putting one’s hands over one’s ears	VP
posture slumping slightly	NP,VP
refusing to answer letting the silence do the talking	VP
finger-tapping a tabletop	VP
a tight or roiling stomach	NP
standing with hands tucked in one’s armpits thumbs visible and pointing up	VP
congratulating the victor	VP
smiles that quickly fade	VP
an expanding feeling in the chest	NP
hoping or praying it will work out	VP
snorting loudly	VP
clenching or hiding one’s hands to hide sweating or shaking	VP
a need to control	DT,VP
opening the mouth to criticize then stopping short	VP
eyes going up looking heavenward	NP,VP
difficulty being articulate	NP
taking risks or breaking laws to be near or with the subject	VP
poking or prodding at something	VP
pulling back slightly	VP
fatigue lacking energy	VP
slow even breaths	NP
lunging at an enemy	VP
frustration at unfairness or a lack of justice	NP
suggesting a trial basis as a solution	VP
mirroring the leader’s movements	VP
keeping silent	VP
loss of respect from others for unfinished or inaccurate work	NP
a high chin	NP
hysteria	NP
asking others to reaffirm the chances of success	VP
a feeling of nakedness of being on display	NP
glancing to see if others are experiencing the same thing	VP
a flushed appearance	NP
unresponsive or slowed reactions to stimulus	NP
sleeping too much	VP
propping the head up with a fist	VP
a disconnect where the mind struggles with belief this can’t be happening	DT,VP
jerking away from contact or even the suggestion of contact	VP
obsessively talking about an achievement or material object	VP
making excuses to leave	VP
balling the hands into fists	VP
noise sensitivity	NP
thinking about the time or future events	VP
a firm belief in one’s own rightness and superiority	NP
rolling one’s shoulders and neck as if stiff	NP
a primal scream	NP
setting up the suspect in the hopes he will reveal his true self	VP
shedding bad habits or flaws to appease or impress	VP
nodding but tightly as if holding back from speaking an insult	VP
responding immediately when called upon	VP
a compulsion to detour toward something new	NP
offering encouragement and support	VP
pursing the lips in thought	VP
a pleading tone	NP
egging the target on	VP
pulling a ball cap low	VP
pressing one’s lips together	VP
licking or biting the bottom lip	VP
throwing or kicking things	VP
a harried wild appearance	NP
making a hmmm noise or throat clearing	VP
appearing relaxed drumming fingers against a leg humming	NP,VP
a slow smile that builds	NP
carrying something that represents the subject a picture clothes	VP
seeking to discredit the source so as not to have to believe him or her	VP
thumbing the ear	VP
interrupting talking over someone else	VP
stopping to pay attention a sudden halt a fork pausing halfway to the mouth	VP
furtively watching the clock or door	VP
asking for opinions or advice	VP
wide eyes showing the whites	NP,VP
tears sobbing	NP
a desire to vent and voice the rival’s unworthiness to others	NP
making the sign of the cross if religious	VP
repeatedly touching an object that symbolizes safety	VP
smoothing one’s clothing to appear collected or worthy	VP
violently rolling shoulders as if one’s own clothing is creating discomfort	VP
chewing on a fingernail picking at cuticles	VP
fussing with clothes rearranging things	VP
vomiting or dry heaves	ADJP,VP
speaking praise and compliments	NP
checking and rechecking one’s appearance	VP
keeping still	VP
a willingness to take on responsibility to help or lead	NP
pain in the jaw from clenching or grinding teeth	VP
a dark mood that no one can reach through or dispel	NP
a pounding heartbeat that grows loud in the ears	NP
breath bursting in and out	VP
raising a hand to ward off others from approaching or speaking	VP
saying that sucks or yeah i hear you or i feel you man	VP
a downward gaze	NP
the stomach tightening and hardening	NP,VP
flighty hand movements fidgeting	NP
eyes shining glossing over and softening	NP,VP
thinking positive thoughts	VP
worrying when too much time has passed without contact	VP
storming away	VP
spying or eavesdropping on others to feel a part of something	NP
going about one’s daily activities with the mind somewhere else	VP
opening and closing the mouth	VP
a gaping mouth	NP
pushing and shoving	VP
rubbing the back of the neck without making eye contact	VP
staying at a distance	VP
cancelling gestures smiling while shaking the head nodding and grimacing	VP
drawing in slow steady breaths	VP
finding somewhere to be alone	VP
choppy responses short sentences	NP
keeping one’s back to a wall or corner	VP
rubbing at one’s lips	VP
blurred vision	VP
eyes wide rounded with very few blinks	NP,ADJP
delighting in even mundane everyday tasks	VP
gasping and expelling one’s breath as if pained	VP
a racing pulse	NP
impatience	NP
furtive movements	NP
eyes appearing damp and overly bright	NP,ADJP
lack of energy	NP
whistling or humming	VP
a half-hearted shrug	NP
excusing oneself to use the restroom or get a drink to be alone	VP
breaths that catch in the chest	NP
desiring to repay another’s kindness and support	VP
being too friendly and coming across as desperate	S,CC,S
clearing the throat	VP
frustration	NP
forcing a slow gait rather than rushing to be with the object	VP
a grin that can’t be contained no matter how hard one tries	NP
enjoying listening to others	VP
asking too many questions	VP
gulping air	NP
focused listening	NP
the mind racing through possible arguments	NP,VP
getting into someone’s personal space	VP
eyebrows that squish together	NP
flight response looking for an escape or fleeing the room	NP,VP
tapping one’s fingers to release energy	VP
rocking slightly	VP
losing track of the time while remembering	VP
silence or minimal responses	NP
pausing to examine	VP
a strained relationship	NP
a gleam in one’s eye an inner light	NP
backing away in quick jerky steps from something or someone	VP
laying the blame on others	VP
shuffling one’s feet	VP
sensitivity to noise and movement	NP
deploying sarcasm insulting others	NP
paranoia that others know and are passing judgment	NP
searching internally for answers rather than asking others	VP
a mouth that opens but nothing comes out	NP,VP
walking with wide steps	VP
bullying tactics	NP
standing taller squaring one’s shoulders	VP
dark circles under one’s eyes	NP
tossing the hair	VP
prying or snooping	VP
sighing heavily or with exaggeration	VP
holding the knees and legs tightly together	VP
agreeing with everything in an attempt to seem “part of the group”	VP
a bleak mood that affects others lessens energy brings people down	NP,VP
clicking one’s fingernails against a table	VP
a strong awareness of one’s own heartbeat	NP
a lowering brow	NP
using insults to pick a fight	VP
cocking the head while raising the eyebrows	VP
a bent spine	NP
listening to and connecting with love songs	VP
a desire for more natural living	NP
asking to talk	VP
not defending oneself against attack verbal or physical	RB,VP
disinterest in one’s appearance bland clothing lackluster hair	NP
looking to others for backup	VP
clasping one’s hands in one’s lap	VP
rubbing or pressing a fist against the chest	VP
rudeness saying something that is a “low blow”	VP
thoughts that turn inward	NP
acting on violent urges throwing a chair destroying property	S,VP
dragging the palms down one’s pant legs	VP
responding slowly accepting an item offering assistance	VP
stroking self rubbing an arm absently for contact	VP
rubbing hands down one’s pant legs	VP
keeping trinkets pictures or articles of the subject	VP
an intense desire to share the feeling with others	NP
short fast breaths	NP
tensing the body to ward off shaking	VP
muttering shaking the head	VP
positive thinking	NP
focusing on the object’s most desirable qualities	VP
a perpetual slouch	NP
a wavering voice	NP
doubting oneself a decrease in confidence	VP
moaning whimpering	VP
the belief that everyone else is deluded	NP
writing notes or poetry to the other person	VP
heart giving out	NP,VP
eyes appear red	NP,VP
filling schedule with work or volunteering to avoid downtime	VP
mental fatigue	NP
moving to get closer or touch	VP
babbling or talking over one another in a group setting	VP
offering gifts of time value or thoughtfulness	VP
covering one’s face and then peeking	VP
a noncommittal answer maybe or we’ll see	NP,ADVP,VP
rubbing the brow as if to ward off a headache	VP
eyes tearing	NP,VP
listening while participating in another activity	VP
a gleam in one’s eye	NP
a prickling of the scalp	NP
brain scrambling to find a logical excuse if lying	NP
wishing it hadn’t happened	VP
shows of affection	NP
pressing the palms downward to stave off over-confidence	VP
heat rising behind the eyelids	VP
slight pauses before reacting	NP,VP
a probing gaze	NP
an inability to concentrate	NP
sullenness	NP
gasping or letting out a sharp scream	VP
running hands through one’s hair	VP
centering all aspects of one’s life on being with the object	VP
holding a hand up to ward off the truth	VP
stomping or stamping	VP
open palms	NP
giving someone the thumbs-up	VP
trembling chin and lips	VP
leaning over with the hands on the knees	VP
offering witty commentary	VP
cheeks that burn	NP
a hoarse voice from screaming yelling or shouting	NP
lowering the head the neck appearing to shrink	VP
excusing oneself and leaving	VP
spinning away	NP
hands moving in jerks	VP
the tongue darting out to touch or lick the lips	NP,VP
